country,year,month,week,date,population,weekly_count,weekly_count_prop,cumulative_count,cumulative_count_prop
Albania,2020,18323,9,2020-03-02,2845955,2,0.07027518003622686,2,0.07027518003622686
Albania,2020,18330,10,2020-03-09,2845955,40,1.4055036007245372,42,1.4055036007245372
Albania,2020,18337,11,2020-03-16,2845955,47,1.6514667308513311,89,1.6514667308513311
Albania,2020,18344,12,2020-03-23,2845955,123,4.321923572227951,212,4.321923572227951
Albania,2020,18351,13,2020-03-30,2845955,149,5.2355009126989005,361,5.2355009126989005
Albania,2020,18358,14,2020-04-06,2845955,85,2.9866951515396414,446,2.9866951515396414
Albania,2020,18365,15,2020-04-13,2845955,116,4.075960442101158,562,4.075960442101158
Albania,2020,18372,16,2020-04-20,2845955,164,5.7625647629706025,726,5.7625647629706025
Albania,2020,18379,17,2020-04-27,2845955,69,2.4244937112498266,795,2.4244937112498266
Albania,2020,18386,18,2020-05-04,2845955,73,2.5650440713222804,868,2.5650440713222804
Albania,2020,18393,19,2020-05-11,2845955,78,2.7407320214128474,946,2.7407320214128474
Albania,2020,18400,20,2020-05-18,2845955,52,1.8271546809418981,998,1.8271546809418981
Albania,2020,18407,21,2020-05-25,2845955,139,4.884125012517766,1137,4.884125012517766
Albania,2020,18414,22,2020-06-01,2845955,109,3.8299973119743638,1246,3.8299973119743638
Albania,2020,18421,23,2020-06-08,2845955,275,9.662837254981193,1521,9.662837254981193
Albania,2020,18428,24,2020-06-15,2845955,406,14.265861547354051,1927,14.265861547354051
Albania,2020,18435,25,2020-06-22,2845955,475,16.690355258603876,2402,16.690355258603876
Albania,2020,18442,26,2020-06-29,2845955,491,17.25255669889369,2893,17.25255669889369
Albania,2020,18449,27,2020-07-06,2845955,561,19.712188000161632,3454,19.712188000161632
Albania,2020,18456,28,2020-07-13,2845955,636,22.34750725152014,4090,22.34750725152014
Albania,2020,18463,29,2020-07-20,2845955,673,23.64759808219034,4763,23.64759808219034
Albania,2020,18470,30,2020-07-27,2845955,756,26.56401805369375,5519,26.56401805369375
Albania,2020,18477,31,2020-08-03,2845955,892,31.34273029615718,6411,31.34273029615718
Albania,2020,18484,32,2020-08-10,2845955,969,34.048324727551915,7380,34.048324727551915
Albania,2020,18491,33,2020-08-17,2845955,1047,36.78905674896476,8427,36.78905674896476
Albania,2020,18498,34,2020-08-24,2845955,953,33.486123287262096,9380,33.486123287262096
Albania,2020,18505,35,2020-08-31,2845955,875,30.74539126584925,10255,30.74539126584925
Albania,2020,18512,36,2020-09-07,2845955,1098,38.581073839888546,11353,38.581073839888546
Albania,2020,18519,37,2020-09-14,2845955,1032,36.26199289869306,12385,36.26199289869306
Albania,2020,18526,38,2020-09-21,2845955,874,30.710253675831137,13259,30.710253675831137
Albania,2020,18533,39,2020-09-28,2845955,1007,35.383553148240225,14266,35.383553148240225
Albania,2020,18540,40,2020-10-05,2845955,1133,39.81088949052251,15399,39.81088949052251
Albania,2020,18547,41,2020-10-12,2845955,1656,58.187849069995835,17055,58.187849069995835
Albania,2020,18554,42,2020-10-19,2845955,2102,73.85921421807443,19157,73.85921421807443
Albania,2020,18561,43,2020-10-26,2845955,2045,71.85637158704196,21202,71.85637158704196
Albania,2020,18568,44,2020-11-02,2845955,3004,105.55332041441274,24206,105.55332041441274
Albania,2020,18575,45,2020-11-09,2845955,3624,127.33862622564307,27830,127.33862622564307
Albania,2020,18582,46,2020-11-16,2845955,4931,173.26345637931732,32761,173.26345637931732
Albania,2020,18589,47,2020-11-23,2845955,4864,170.90923784810371,37625,170.90923784810371
Albania,2020,18596,48,2020-11-30,2845955,5363,188.44289526714232,42988,188.44289526714232
Albania,2020,18603,49,2020-12-07,2845955,5542,194.7325238803846,48530,194.7325238803846
Albania,2020,18610,50,2020-12-14,2845955,4473,157.17044015102135,53003,157.17044015102135
Albania,2020,18617,51,2020-12-21,2845955,3569,125.40605877464682,56572,125.40605877464682
Albania,2020,18624,52,2020-12-28,2845955,2866,100.70433299191308,59438,100.70433299191308
Albania,2021,18631,0,2021-01-04,2845955,4157,146.06696170529753,63595,146.06696170529753
Albania,2021,18631,1,2021-01-04,2845955,4095,143.88843112417447,67690,143.88843112417447
Albania,2021,18638,2,2021-01-11,2845955,4584,161.07071264303195,72274,161.07071264303195
Albania,2021,18645,3,2021-01-18,2845955,5853,205.66031437601788,78127,205.66031437601788
Albania,2021,18652,4,2021-01-25,2845955,7209,253.3068864405797,85336,253.3068864405797
Albania,2021,18659,5,2021-02-01,2845955,7739,271.92980915017984,93075,271.92980915017984
Albania,2021,18666,6,2021-02-08,2845955,7171,251.97165801989138,100246,251.97165801989138
Albania,2021,18673,7,2021-02-15,2845955,6921,243.18726051536302,107167,243.18726051536302
Albania,2021,18680,8,2021-02-22,2845955,5730,201.33839080378993,112897,201.33839080378993
Albania,2021,18687,9,2021-03-01,2845955,4577,160.82474951290516,117474,160.82474951290516
Albania,2021,18694,10,2021-03-08,2845955,3726,130.92266040749064,121200,130.92266040749064
Albania,2021,18701,11,2021-03-15,2845955,2934,103.09368911314479,124134,103.09368911314479
Albania,2021,18708,12,2021-03-22,2845955,2397,84.22480327341789,126531,84.22480327341789
Albania,2021,18715,13,2021-03-29,2845955,1862,65.4261926137272,128393,65.4261926137272
Albania,2021,18722,14,2021-04-05,2845955,1201,42.20024561175423,129594,42.20024561175423
Albania,2021,18729,15,2021-04-12,2845955,943,33.134747387080964,130537,33.134747387080964
Albania,2021,18736,16,2021-04-19,2845955,701,24.631450602697512,131238,24.631450602697512
Albania,2021,18743,17,2021-04-26,2845955,485,17.041731158785012,131723,17.041731158785012
Albania,2021,18750,18,2021-05-03,2845955,292,10.260176285289122,132015,10.260176285289122
Albania,2021,18757,19,2021-05-10,2845955,194,6.816692463514005,132209,6.816692463514005
Albania,2021,18764,20,2021-05-17,2845955,100,3.513759001811343,132309,3.513759001811343
Albania,2021,18771,21,2021-05-24,2845955,70,2.45963130126794,132379,2.45963130126794
Albania,2021,18778,22,2021-05-31,2845955,82,2.8812823814853012,132461,2.8812823814853012
Albania,2021,18785,23,2021-06-07,2845955,29,1.0189901105252894,132490,1.0189901105252894
Albania,2021,18792,24,2021-06-14,2845955,22,0.7730269803984954,132512,0.7730269803984954
Albania,2021,18799,25,2021-06-21,2845955,23,0.8081645704166088,132535,0.8081645704166088
Albania,2021,18806,26,2021-06-28,2845955,57,2.002842631032465,132592,2.002842631032465
Albania,2021,18813,27,2021-07-05,2845955,94,3.3029334617026622,132686,3.3029334617026622
Albania,2021,18820,28,2021-07-12,2845955,171,6.008527893097396,132857,6.008527893097396
Albania,2021,18827,29,2021-07-19,2845955,264,9.276323764781944,133121,9.276323764781944
Albania,2021,18834,30,2021-07-26,2845955,791,27.79383370432772,133912,27.79383370432772
Albania,2021,18841,31,2021-08-02,2845955,2035,71.50499568686082,135947,71.50499568686082
Albania,2021,18848,32,2021-08-09,2845955,3377,118.65964149116904,139324,118.65964149116904
Albania,2021,18855,33,2021-08-16,2845955,5523,194.06490967004046,144847,194.06490967004046
Albania,2021,18862,34,2021-08-23,2845955,6150,216.0961786113976,150997,216.0961786113976
Albania,2021,18869,35,2021-08-30,2845955,6029,211.84453021920586,157026,211.84453021920586
Albania,2021,18876,36,2021-09-06,2845955,5927,208.26049603735828,162953,208.26049603735828
Albania,2021,18883,37,2021-09-13,2845955,4940,173.57969468948033,167893,173.57969468948033
Albania,2021,18890,38,2021-09-20,2845955,3901,137.0717386606605,171794,137.0717386606605
Albania,2021,18897,39,2021-09-27,2845955,3174,111.52671071749202,174968,111.52671071749202
Albania,2021,18904,40,2021-10-04,2845955,3003,105.51818282439463,177971,105.51818282439463
Albania,2021,18911,41,2021-10-11,2845955,3725,130.88752281747253,181696,130.88752281747253
Albania,2021,18918,42,2021-10-18,2845955,3604,126.63587442528079,185300,126.63587442528079
Albania,2021,18925,43,2021-10-25,2845955,3825,134.40128181928387,189125,134.40128181928387
Andorra,2020,18330,10,2020-03-09,76177,5,6.563660947530094,5,6.563660947530094
Andorra,2020,18337,11,2020-03-16,76177,108,141.77507646665003,113,141.77507646665003
Andorra,2020,18344,12,2020-03-23,76177,221,290.11381388083015,334,290.11381388083015
Andorra,2020,18351,13,2020-03-30,76177,167,219.22627564750516,501,219.22627564750516
Andorra,2020,18358,14,2020-04-06,76177,137,179.8443099623246,638,179.8443099623246
Andorra,2020,18365,15,2020-04-13,76177,75,98.45491421295142,713,98.45491421295142
Andorra,2020,18372,16,2020-04-20,76177,27,35.44376911666251,740,35.44376911666251
Andorra,2020,18379,17,2020-04-27,76177,8,10.501857516048151,748,10.501857516048151
Andorra,2020,18386,18,2020-05-04,76177,7,9.189125326542133,755,9.189125326542133
Andorra,2020,18393,19,2020-05-11,76177,6,7.876393137036113,761,7.876393137036113
Andorra,2020,18400,20,2020-05-18,76177,2,2.6254643790120378,763,2.6254643790120378
Andorra,2020,18407,21,2020-05-25,76177,1,1.3127321895060189,764,1.3127321895060189
Andorra,2020,18414,22,2020-06-01,76177,88,115.52043267652967,852,115.52043267652967
Andorra,2020,18421,23,2020-06-08,76177,1,1.3127321895060189,853,1.3127321895060189
Andorra,2020,18428,24,2020-06-15,76177,2,2.6254643790120378,855,2.6254643790120378
Andorra,2020,18435,25,2020-06-22,76177,0,0,855,0
Andorra,2020,18442,26,2020-06-29,76177,0,0,855,0
Andorra,2020,18449,27,2020-07-06,76177,0,0,855,0
Andorra,2020,18456,28,2020-07-13,76177,25,32.81830473765047,880,32.81830473765047
Andorra,2020,18463,29,2020-07-20,76177,17,22.31644722160232,897,22.31644722160232
Andorra,2020,18470,30,2020-07-27,76177,28,36.75650130616853,925,36.75650130616853
Andorra,2020,18477,31,2020-08-03,76177,31,40.69469787468658,956,40.69469787468658
Andorra,2020,18484,32,2020-08-10,76177,33,43.320162253698626,989,43.320162253698626
Andorra,2020,18491,33,2020-08-17,76177,56,73.51300261233706,1045,73.51300261233706
Andorra,2020,18498,34,2020-08-24,76177,79,103.7058429709755,1124,103.7058429709755
Andorra,2020,18505,35,2020-08-31,76177,91,119.45862924504772,1215,119.45862924504772
Andorra,2020,18512,36,2020-09-07,76177,129,169.34245244627644,1344,169.34245244627644
Andorra,2020,18519,37,2020-09-14,76177,220,288.80108169132416,1564,288.80108169132416
Andorra,2020,18526,38,2020-09-21,76177,272,357.06315554563713,1836,357.06315554563713
Andorra,2020,18533,39,2020-09-28,76177,274,359.6886199246492,2110,359.6886199246492
Andorra,2020,18540,40,2020-10-05,76177,586,769.261063050527,2696,769.261063050527
Andorra,2020,18547,41,2020-10-12,76177,681,893.9706210535988,3377,893.9706210535988
Andorra,2020,18554,42,2020-10-19,76177,661,867.7159772634785,4038,867.7159772634785
Andorra,2020,18561,43,2020-10-26,76177,787,1033.120233141237,4825,1033.120233141237
Andorra,2020,18568,44,2020-11-02,76177,558,732.5045617443585,5383,732.5045617443585
Andorra,2020,18575,45,2020-11-09,76177,489,641.9260406684432,5872,641.9260406684432
Andorra,2020,18582,46,2020-11-16,76177,384,504.08916077031125,6256,504.08916077031125
Andorra,2020,18589,47,2020-11-23,76177,456,598.6058784147446,6712,598.6058784147446
Andorra,2020,18596,48,2020-11-30,76177,338,443.70348005303435,7050,443.70348005303435
Andorra,2020,18603,49,2020-12-07,76177,288,378.0668705777334,7338,378.0668705777334
Andorra,2020,18610,50,2020-12-14,76177,239,313.7429932919385,7577,313.7429932919385
Andorra,2020,18617,51,2020-12-21,76177,10,13.127321895060188,7587,13.127321895060188
Andorra,2020,18624,52,2020-12-28,76177,605,794.2029746511414,8192,794.2029746511414
Andorra,2021,18631,0,2021-01-04,76177,490,643.2387728579492,8682,643.2387728579492
Andorra,2021,18631,1,2021-01-04,76177,401,526.4056079919136,9083,526.4056079919136
Andorra,2021,18638,2,2021-01-11,76177,466,611.7332003098048,9549,611.7332003098048
Andorra,2021,18645,3,2021-01-18,76177,388,509.34008952833534,9937,509.34008952833534
Andorra,2021,18652,4,2021-01-25,76177,314,412.19790750488994,10251,412.19790750488994
Andorra,2021,18659,5,2021-02-01,76177,287,376.75413838822743,10538,376.75413838822743
Andorra,2021,18666,6,2021-02-08,76177,161,211.34988251046903,10699,211.34988251046903
Andorra,2021,18673,7,2021-02-15,76177,190,249.41911600614358,10889,249.41911600614358
Andorra,2021,18680,8,2021-02-22,76177,180,236.2917941110834,11069,236.2917941110834
Andorra,2021,18687,9,2021-03-01,76177,157,206.09895375244497,11226,206.09895375244497
Andorra,2021,18694,10,2021-03-08,76177,319,418.76156845242,11545,418.76156845242
Andorra,2021,18701,11,2021-03-15,76177,305,400.38331779933577,11850,400.38331779933577
Andorra,2021,18708,12,2021-03-22,76177,381,500.1509642017932,12231,500.1509642017932
Andorra,2021,18715,13,2021-03-29,76177,350,459.4562663271066,12581,459.4562663271066
Andorra,2021,18722,14,2021-04-05,76177,224,294.05201044934824,12805,294.05201044934824
Andorra,2021,18729,15,2021-04-12,76177,278,364.93954868267326,13083,364.93954868267326
Andorra,2021,18736,16,2021-04-19,76177,212,278.299224175276,13295,278.299224175276
Andorra,2021,18743,17,2021-04-26,76177,128,168.02972025677042,13423,168.02972025677042
Andorra,2021,18750,18,2021-05-03,76177,87,114.20770048702364,13510,114.20770048702364
Andorra,2021,18757,19,2021-05-10,76177,99,129.96048676109586,13609,129.96048676109586
Andorra,2021,18764,20,2021-05-17,76177,118,154.90239836171023,13727,154.90239836171023
Andorra,2021,18771,21,2021-05-24,76177,50,65.63660947530094,13777,65.63660947530094
Andorra,2021,18778,22,2021-05-31,76177,36,47.25835882221668,13813,47.25835882221668
Andorra,2021,18785,23,2021-06-07,76177,51,66.94934166480697,13864,66.94934166480697
Andorra,2021,18792,24,2021-06-14,76177,18,23.62917941110834,13882,23.62917941110834
Andorra,2021,18799,25,2021-06-21,76177,109,143.08780865615606,13991,143.08780865615606
Andorra,2021,18806,26,2021-06-28,76177,164,215.2880790789871,14155,215.2880790789871
Andorra,2021,18813,27,2021-07-05,76177,204,267.79736665922786,14359,267.79736665922786
Andorra,2021,18820,28,2021-07-12,76177,218,286.1756173123121,14577,286.1756173123121
Andorra,2021,18827,29,2021-07-19,76177,170,223.1644722160232,14747,223.1644722160232
Andorra,2021,18834,30,2021-07-26,76177,129,169.34245244627644,14876,169.34245244627644
Andorra,2021,18841,31,2021-08-02,76177,78,102.39311078146947,14954,102.39311078146947
Andorra,2021,18848,32,2021-08-09,76177,48,63.01114509628891,15002,63.01114509628891
Andorra,2021,18855,33,2021-08-16,76177,30,39.38196568518057,15032,39.38196568518057
Andorra,2021,18862,34,2021-08-23,76177,37,48.5710910117227,15069,48.5710910117227
Andorra,2021,18869,35,2021-08-30,76177,14,18.378250653084265,15083,18.378250653084265
Andorra,2021,18876,36,2021-09-06,76177,57,74.82573480184307,15140,74.82573480184307
Andorra,2021,18883,37,2021-09-13,76177,49,64.32387728579492,15189,64.32387728579492
Andorra,2021,18890,38,2021-09-20,76177,78,102.39311078146947,15267,102.39311078146947
Andorra,2021,18897,39,2021-09-27,76177,40,52.50928758024075,15307,52.50928758024075
Andorra,2021,18904,40,2021-10-04,76177,60,78.763931370361135,15367,78.763931370361135
Andorra,2021,18911,41,2021-10-11,76177,58,76.13846699134909,15425,76.13846699134909
Andorra,2021,18918,42,2021-10-18,76177,91,119.45862924504772,15516,119.45862924504772
Andorra,2021,18925,43,2021-10-25,76177,189,248.10638381663756,15705,248.10638381663756
Armenia,2020,18267,0,2020-01-06,2963234,0,0,0,0
Armenia,2020,18267,1,2020-01-06,2963234,0,0,0,0
Armenia,2020,18274,2,2020-01-13,2963234,0,0,0,0
Armenia,2020,18281,3,2020-01-20,2963234,0,0,0,0
Armenia,2020,18288,4,2020-01-27,2963234,0,0,0,0
Armenia,2020,18295,5,2020-02-03,2963234,0,0,0,0
Armenia,2020,18302,6,2020-02-10,2963234,0,0,0,0
Armenia,2020,18309,7,2020-02-17,2963234,0,0,0,0
Armenia,2020,18316,8,2020-02-24,2963234,1,0.03374691300113322,1,0.03374691300113322
Armenia,2020,18323,9,2020-03-02,2963234,0,0,1,0
Armenia,2020,18330,10,2020-03-09,2963234,27,0.911166651030597,28,0.911166651030597
Armenia,2020,18337,11,2020-03-16,2963234,166,5.601987558188115,194,5.601987558188115
Armenia,2020,18344,12,2020-03-23,2963234,288,9.719110944326367,482,9.719110944326367
Armenia,2020,18351,13,2020-03-30,2963234,351,11.84516646339776,833,11.84516646339776
Armenia,2020,18358,14,2020-04-06,2963234,206,6.951864078233443,1039,6.951864078233443
Armenia,2020,18365,15,2020-04-13,2963234,300,10.124073900339967,1339,10.124073900339967
Armenia,2020,18372,16,2020-04-20,2963234,469,15.82730219753148,1808,15.82730219753148
Armenia,2020,18379,17,2020-04-27,2963234,699,23.589092187792122,2507,23.589092187792122
Armenia,2020,18386,18,2020-05-04,2963234,885,29.8660180060029,3392,29.8660180060029
Armenia,2020,18393,19,2020-05-11,2963234,1431,48.29183250462164,4823,48.29183250462164
Armenia,2020,18400,20,2020-05-18,2963234,2290,77.28043077259508,7113,77.28043077259508
Armenia,2020,18407,21,2020-05-25,2963234,2379,80.28390602969593,9492,80.28390602969593
Armenia,2020,18414,22,2020-06-01,2963234,3833,129.35191753334362,13325,129.35191753334362
Armenia,2020,18421,23,2020-06-08,2963234,3739,126.17970771123711,17064,126.17970771123711
Armenia,2020,18428,24,2020-06-15,2963234,3524,118.92412141599347,20588,118.92412141599347
Armenia,2020,18435,25,2020-06-22,2963234,4539,153.1772381121437,25127,153.1772381121437
Armenia,2020,18442,26,2020-06-29,2963234,3809,128.54199162131644,28936,128.54199162131644
Armenia,2020,18449,27,2020-07-06,2963234,3215,108.49632529864331,32151,108.49632529864331
Armenia,2020,18456,28,2020-07-13,2963234,2830,95.50376379320701,34981,95.50376379320701
Armenia,2020,18463,29,2020-07-20,2963234,2409,81.29631341972993,37390,81.29631341972993
Armenia,2020,18470,30,2020-07-27,2963234,1712,57.77471505794008,39102,57.77471505794008
Armenia,2020,18477,31,2020-08-03,2963234,1308,44.14096220548225,40410,44.14096220548225
Armenia,2020,18484,32,2020-08-10,2963234,1253,42.284881990419926,41663,42.284881990419926
Armenia,2020,18491,33,2020-08-17,2963234,1129,38.10026477827941,42792,38.10026477827941
Armenia,2020,18498,34,2020-08-24,2963234,958,32.329542655085625,43750,32.329542655085625
Armenia,2020,18505,35,2020-08-31,2963234,1033,34.860561130170616,44783,34.860561130170616
Armenia,2020,18512,36,2020-09-07,2963234,1079,36.41291912822275,45862,36.41291912822275
Armenia,2020,18519,37,2020-09-14,2963234,1569,52.94890649877802,47431,52.94890649877802
Armenia,2020,18526,38,2020-09-21,2963234,1969,66.44767169923131,49400,66.44767169923131
Armenia,2020,18533,39,2020-09-28,2963234,3096,104.48044265150845,52496,104.48044265150845
Armenia,2020,18540,40,2020-10-05,2963234,3955,133.4690409194819,56451,133.4690409194819
Armenia,2020,18547,41,2020-10-12,2963234,8243,278.1758038683411,64694,278.1758038683411
Armenia,2020,18554,42,2020-10-19,2963234,14116,476.37142392399653,78810,476.37142392399653
Armenia,2020,18561,43,2020-10-26,2963234,14638,493.9873125105881,93448,493.9873125105881
Armenia,2020,18568,44,2020-11-02,2963234,14018,473.0642264498855,107466,473.0642264498855
Armenia,2020,18575,45,2020-11-09,2963234,10420,351.64283347180816,117886,351.64283347180816
Armenia,2020,18582,46,2020-11-16,2963234,8823,297.7490134089984,126709,297.7490134089984
Armenia,2020,18589,47,2020-11-23,2963234,8415,283.98027290453604,135124,283.98027290453604
Armenia,2020,18596,48,2020-11-30,2963234,7220,243.65271186818185,142344,243.65271186818185
Armenia,2020,18603,49,2020-12-07,2963234,6338,213.88793460118237,148682,213.88793460118237
Armenia,2020,18610,50,2020-12-14,2963234,5383,181.65963268510012,154065,181.65963268510012
Armenia,2020,18617,51,2020-12-21,2963234,3883,131.0392631834003,157948,131.0392631834003
Armenia,2020,18624,52,2020-12-28,2963234,2272,76.67298633857467,160220,76.67298633857467
Armenia,2021,18631,0,2021-01-04,2963234,2068,69.7886160863435,162288,69.7886160863435
Armenia,2021,18631,1,2021-01-04,2963234,2388,80.58762824670613,164676,80.58762824670613
Armenia,2021,18638,2,2021-01-11,2963234,1418,47.85312263560691,166094,47.85312263560691
Armenia,2021,18645,3,2021-01-18,2963234,994,33.54443152312642,167088,33.54443152312642
Armenia,2021,18652,4,2021-01-25,2963234,1089,36.750388258234075,168177,36.750388258234075
Armenia,2021,18659,5,2021-02-01,2963234,1078,36.379172215221615,169255,36.379172215221615
Armenia,2021,18666,6,2021-02-08,2963234,1147,38.707709212299804,170402,38.707709212299804
Armenia,2021,18673,7,2021-02-15,2963234,1814,61.21690018405566,172216,61.21690018405566
Armenia,2021,18680,8,2021-02-22,2963234,2800,94.49135640317301,175016,94.49135640317301
Armenia,2021,18687,9,2021-03-01,2963234,3686,124.39112132217706,178702,124.39112132217706
Armenia,2021,18694,10,2021-03-08,2963234,5517,186.18171902725197,184219,186.18171902725197
Armenia,2021,18701,11,2021-03-15,2963234,6522,220.09736659339086,190741,220.09736659339086
Armenia,2021,18708,12,2021-03-22,2963234,6372,215.03532964322088,197113,215.03532964322088
Armenia,2021,18715,13,2021-03-29,2963234,6214,209.70331738904184,203327,209.70331738904184
Armenia,2021,18722,14,2021-04-05,2963234,5491,185.3042992892225,208818,185.3042992892225
Armenia,2021,18729,15,2021-04-12,2963234,4651,156.95689236827062,213469,156.95689236827062
Armenia,2021,18736,16,2021-04-19,2963234,3539,119.43032511101048,217008,119.43032511101048
Armenia,2021,18743,17,2021-04-26,2963234,2345,79.1365109876574,219353,79.1365109876574
Armenia,2021,18750,18,2021-05-03,2963234,1574,53.117641063783694,220927,53.117641063783694
Armenia,2021,18757,19,2021-05-10,2963234,1055,35.60299321619555,221982,35.60299321619555
Armenia,2021,18764,20,2021-05-17,2963234,688,23.217876144779655,222670,23.217876144779655
Armenia,2021,18771,21,2021-05-24,2963234,542,18.290826846614205,223212,18.290826846614205
Armenia,2021,18778,22,2021-05-31,2963234,511,17.244672543579075,223723,17.244672543579075
Armenia,2021,18785,23,2021-06-07,2963234,530,17.885863890600607,224253,17.885863890600607
Armenia,2021,18792,24,2021-06-14,2963234,598,20.180653974677668,224851,20.180653974677668
Armenia,2021,18799,25,2021-06-21,2963234,755,25.47891931585558,225606,25.47891931585558
Armenia,2021,18806,26,2021-06-28,2963234,853,28.786116789966638,226459,28.786116789966638
Armenia,2021,18813,27,2021-07-05,2963234,1063,35.872968520204616,227522,35.872968520204616
Armenia,2021,18820,28,2021-07-12,2963234,1388,46.84071524557291,228910,46.84071524557291
Armenia,2021,18827,29,2021-07-19,2963234,1566,52.84766575977462,230476,52.84766575977462
Armenia,2021,18834,30,2021-07-26,2963234,1821,61.453128575063594,232297,61.453128575063594
Armenia,2021,18841,31,2021-08-02,2963234,2517,84.94098002385232,234814,84.94098002385232
Armenia,2021,18848,32,2021-08-09,2963234,3071,103.63676982648012,237885,103.63676982648012
Armenia,2021,18855,33,2021-08-16,2963234,3726,125.74099784222238,241611,125.74099784222238
Armenia,2021,18862,34,2021-08-23,2963234,3653,123.27747319313966,245264,123.27747319313966
Armenia,2021,18869,35,2021-08-30,2963234,3882,131.00551627039917,249146,131.00551627039917
Armenia,2021,18876,36,2021-09-06,2963234,4796,161.85019475343492,253942,161.85019475343492
Armenia,2021,18883,37,2021-09-13,2963234,4603,155.33704054421622,258545,155.33704054421622
Armenia,2021,18890,38,2021-09-20,2963234,6772,228.53409484367418,265317,228.53409484367418
Armenia,2021,18897,39,2021-09-27,2963234,7640,257.8264153286578,272957,257.8264153286578
Armenia,2021,18904,40,2021-10-04,2963234,10226,345.09593234958834,283183,345.09593234958834
Armenia,2021,18911,41,2021-10-11,2963234,13369,451.16247991215005,296552,451.16247991215005
Armenia,2021,18918,42,2021-10-18,2963234,12845,433.47909749955625,309397,433.47909749955625
Armenia,2021,18925,43,2021-10-25,2963234,11846,399.76593141142416,321243,399.76593141142416
Austria,2020,18267,0,2020-01-06,8901064,0,0,0,0
Austria,2020,18267,1,2020-01-06,8901064,0,0,0,0
Austria,2020,18274,2,2020-01-13,8901064,0,0,0,0
Austria,2020,18281,3,2020-01-20,8901064,0,0,0,0
Austria,2020,18288,4,2020-01-27,8901064,0,0,0,0
Austria,2020,18295,5,2020-02-03,8901064,0,0,0,0
Austria,2020,18302,6,2020-02-10,8901064,0,0,0,0
Austria,2020,18309,7,2020-02-17,8901064,0,0,0,0
Austria,2020,18316,8,2020-02-24,8901064,12,0.134815343424112,12,0.134815343424112
Austria,2020,18323,9,2020-03-02,8901064,114,1.280745762529064,126,1.280745762529064
Austria,2020,18330,10,2020-03-09,8901064,874,9.819050846056157,1000,9.819050846056157
Austria,2020,18337,11,2020-03-16,8901064,3068,34.467789468764636,4068,34.467789468764636
Austria,2020,18344,12,2020-03-23,8901064,5128,57.61109008990386,9196,57.61109008990386
Austria,2020,18351,13,2020-03-30,8901064,3116,35.007050842461084,12312,35.007050842461084
Austria,2020,18358,14,2020-04-06,8901064,1838,20.649216767793153,14150,20.649216767793153
Austria,2020,18365,15,2020-04-13,8901064,684,7.6844745751743835,14834,7.6844745751743835
Austria,2020,18372,16,2020-04-20,8901064,448,5.033106154500181,15282,5.033106154500181
Austria,2020,18379,17,2020-04-27,8901064,312,3.505198929026912,15594,3.505198929026912
Austria,2020,18386,18,2020-05-04,8901064,264,2.9659375553304637,15858,2.9659375553304637
Austria,2020,18393,19,2020-05-11,8901064,335,3.7635950039231263,16193,3.7635950039231263
Austria,2020,18400,20,2020-05-18,8901064,265,2.977172167282473,16458,2.977172167282473
Austria,2020,18407,21,2020-05-25,8901064,195,2.19074933064182,16653,2.19074933064182
Austria,2020,18414,22,2020-06-01,8901064,227,2.5502569131061184,16880,2.5502569131061184
Austria,2020,18421,23,2020-06-08,8901064,172,1.9323532557456053,17052,1.9323532557456053
Austria,2020,18428,24,2020-06-15,8901064,248,2.7861837640983147,17300,2.7861837640983147
Austria,2020,18435,25,2020-06-22,8901064,335,3.7635950039231263,17635,3.7635950039231263
Austria,2020,18442,26,2020-06-29,8901064,641,7.201386261237983,18276,7.201386261237983
Austria,2020,18449,27,2020-07-06,8901064,596,6.695828723397562,18872,6.695828723397562
Austria,2020,18456,28,2020-07-13,8901064,784,8.807935770375316,19656,8.807935770375316
Austria,2020,18463,29,2020-07-20,8901064,872,9.796581622152138,20528,9.796581622152138
Austria,2020,18470,30,2020-07-27,8901064,794,8.92028188989541,21322,8.92028188989541
Austria,2020,18477,31,2020-08-03,8901064,722,8.111389829350738,22044,8.111389829350738
Austria,2020,18484,32,2020-08-10,8901064,1462,16.425002673837646,23506,16.425002673837646
Austria,2020,18491,33,2020-08-17,8901064,1907,21.424404992481797,25413,21.424404992481797
Austria,2020,18498,34,2020-08-24,8901064,1941,21.806381798850115,27354,21.806381798850115
Austria,2020,18505,35,2020-08-31,8901064,2268,25.480099907157168,29622,25.480099907157168
Austria,2020,18512,36,2020-09-07,8901064,3997,44.9047439721813,33619,44.9047439721813
Austria,2020,18519,37,2020-09-14,8901064,5211,58.543562881920636,38830,58.543562881920636
Austria,2020,18526,38,2020-09-21,8901064,4656,52.308353248555456,43486,52.308353248555456
Austria,2020,18533,39,2020-09-28,8901064,5597,62.880123095396236,49083,62.880123095396236
Austria,2020,18540,40,2020-10-05,8901064,7486,84.10230507274187,56569,84.10230507274187
Austria,2020,18547,41,2020-10-12,8901064,9903,111.25636216074842,66472,111.25636216074842
Austria,2020,18554,42,2020-10-19,8901064,18275,205.31253342297055,84747,205.31253342297055
Austria,2020,18561,43,2020-10-26,8901064,31614,355.17102225082306,116361,355.17102225082306
Austria,2020,18568,44,2020-11-02,8901064,44759,502.8499963599857,161120,502.8499963599857
Austria,2020,18575,45,2020-11-09,8901064,47880,537.9132202622069,209000,537.9132202622069
Austria,2020,18582,46,2020-11-16,8901064,40742,457.72056014876426,249742,457.72056014876426
Austria,2020,18589,47,2020-11-23,8901064,31162,350.0929776485148,280904,350.0929776485148
Austria,2020,18596,48,2020-11-30,8901064,23078,259.27237462847137,303982,259.27237462847137
Austria,2020,18603,49,2020-12-07,8901064,18701,210.09847811452653,322683,210.09847811452653
Austria,2020,18610,50,2020-12-14,8901064,14864,166.99127205466672,337547,166.99127205466672
Austria,2020,18617,51,2020-12-21,8901064,13340,149.8697234398045,350887,149.8697234398045
Austria,2020,18624,52,2020-12-28,8901064,14896,167.350779637131,365783,167.350779637131
Austria,2021,18631,0,2021-01-04,8901064,14635,164.4185459176566,380418,164.4185459176566
Austria,2021,18631,1,2021-01-04,8901064,10948,122.99653165059817,391366,122.99653165059817
Austria,2021,18638,2,2021-01-11,8901064,10161,114.15489204436683,401527,114.15489204436683
Austria,2021,18645,3,2021-01-18,8901064,9510,106.84115966360875,411037,106.84115966360875
Austria,2021,18652,4,2021-01-25,8901064,9116,102.41472255451708,420153,102.41472255451708
Austria,2021,18659,5,2021-02-01,8901064,9464,106.32436751381633,429617,106.32436751381633
Austria,2021,18666,6,2021-02-08,8901064,11637,130.73717928553262,441254,130.73717928553262
Austria,2021,18673,7,2021-02-15,8901064,14203,159.56519355438854,455457,159.56519355438854
Austria,2021,18680,8,2021-02-22,8901064,16339,183.5623246838805,471796,183.5623246838805
Austria,2021,18687,9,2021-03-01,8901064,18231,204.81821049708213,490027,204.81821049708213
Austria,2021,18694,10,2021-03-08,8901064,21093,236.97166990373285,511120,236.97166990373285
Austria,2021,18701,11,2021-03-15,8901064,22319,250.7453041568963,533439,250.7453041568963
Austria,2021,18708,12,2021-03-22,8901064,20786,233.522644034466,554225,233.522644034466
Austria,2021,18715,13,2021-03-29,8901064,17608,197.81904725098033,571833,197.81904725098033
Austria,2021,18722,14,2021-04-05,8901064,16819,188.95493842084497,588652,188.95493842084497
Austria,2021,18729,15,2021-04-12,8901064,15047,169.04720604188444,603699,169.04720604188444
Austria,2021,18736,16,2021-04-19,8901064,12533,140.80339159453297,616232,140.80339159453297
Austria,2021,18743,17,2021-04-26,8901064,9018,101.31373058322016,625250,101.31373058322016
Austria,2021,18750,18,2021-05-03,8901064,5732,64.3967957089175,630982,64.3967957089175
Austria,2021,18757,19,2021-05-10,8901064,4155,46.67981266059878,635137,46.67981266059878
Austria,2021,18764,20,2021-05-17,8901064,3159,35.49013915639748,638296,35.49013915639748
Austria,2021,18771,21,2021-05-24,8901064,360,4.04446030272336,638656,4.04446030272336
Austria,2021,18778,22,2021-05-31,8901064,0,0,638656,0
Austria,2021,18785,23,2021-06-07,8901064,0,0,638656,0
Austria,2021,18792,24,2021-06-14,8901064,0,0,638656,0
Austria,2021,18799,25,2021-06-21,8901064,353,3.9658180190592947,639009,3.9658180190592947
Austria,2021,18806,26,2021-06-28,8901064,1092,12.268196251594192,640101,12.268196251594192
Austria,2021,18813,27,2021-07-05,8901064,2192,24.626269398804457,642293,24.626269398804457
Austria,2021,18820,28,2021-07-12,8901064,2531,28.434802850535622,644824,28.434802850535622
Austria,2021,18827,29,2021-07-19,8901064,3251,36.52372345598234,648075,36.52372345598234
Austria,2021,18834,30,2021-07-26,8901064,3666,41.186087416066215,651741,41.186087416066215
Austria,2021,18841,31,2021-08-02,8901064,5895,66.22803745709501,657636,66.22803745709501
Austria,2021,18848,32,2021-08-09,8901064,8062,90.57344155709924,665698,90.57344155709924
Austria,2021,18855,33,2021-08-16,8901064,9438,106.03226760306408,675136,106.03226760306408
Austria,2021,18862,34,2021-08-23,8901064,11307,127.02975734136953,686443,127.02975734136953
Austria,2021,18869,35,2021-08-30,8901064,14055,157.90247098549116,700498,157.90247098549116
Austria,2021,18876,36,2021-09-06,8901064,13739,154.3523336086562,714237,154.3523336086562
Austria,2021,18883,37,2021-09-13,8901064,11749,131.99545582415766,725986,131.99545582415766
Austria,2021,18890,38,2021-09-20,8901064,12595,141.49993753555754,738581,141.49993753555754
Austria,2021,18897,39,2021-09-27,8901064,12781,143.5895753586313,751362,143.5895753586313
Austria,2021,18904,40,2021-10-04,8901064,15360,172.56363958286335,766722,172.56363958286335
Austria,2021,18911,41,2021-10-11,8901064,23871,268.1814219064148,790593,268.1814219064148
Austria,2021,18918,42,2021-10-18,8901064,34621,388.9535003905151,825214,388.9535003905151
Austria,2021,18925,43,2021-10-25,8901064,56659,636.5418785888968,881873,636.5418785888968
Azerbaijan,2020,18267,0,2020-01-06,10139175,0,0,0,0
Azerbaijan,2020,18267,1,2020-01-06,10139175,0,0,0,0
Azerbaijan,2020,18274,2,2020-01-13,10139175,0,0,0,0
Azerbaijan,2020,18281,3,2020-01-20,10139175,0,0,0,0
Azerbaijan,2020,18288,4,2020-01-27,10139175,0,0,0,0
Azerbaijan,2020,18295,5,2020-02-03,10139175,0,0,0,0
Azerbaijan,2020,18302,6,2020-02-10,10139175,0,0,0,0
Azerbaijan,2020,18309,7,2020-02-17,10139175,0,0,0,0
Azerbaijan,2020,18316,8,2020-02-24,10139175,3,0.029588206141032185,3,0.029588206141032185
Azerbaijan,2020,18323,9,2020-03-02,10139175,6,0.05917641228206437,9,0.05917641228206437
Azerbaijan,2020,18330,10,2020-03-09,10139175,10,0.09862735380344062,19,0.09862735380344062
Azerbaijan,2020,18337,11,2020-03-16,10139175,46,0.4536858274958268,65,0.4536858274958268
Azerbaijan,2020,18344,12,2020-03-23,10139175,144,1.4202338947695448,209,1.4202338947695448
Azerbaijan,2020,18351,13,2020-03-30,10139175,375,3.698525767629023,584,3.698525767629023
Azerbaijan,2020,18358,14,2020-04-06,10139175,514,5.069445985496848,1098,5.069445985496848
Azerbaijan,2020,18365,15,2020-04-13,10139175,300,2.9588206141032183,1398,2.9588206141032183
Azerbaijan,2020,18372,16,2020-04-20,10139175,247,2.436095638944983,1645,2.436095638944983
Azerbaijan,2020,18379,17,2020-04-27,10139175,287,2.8306050541587457,1932,2.8306050541587457
Azerbaijan,2020,18386,18,2020-05-04,10139175,587,5.7894256682619645,2519,5.7894256682619645
Azerbaijan,2020,18393,19,2020-05-11,10139175,755,7.446365212159766,3274,7.446365212159766
Azerbaijan,2020,18400,20,2020-05-18,10139175,848,8.363599602531764,4122,8.363599602531764
Azerbaijan,2020,18407,21,2020-05-25,10139175,1372,13.531672941832053,5494,13.531672941832053
Azerbaijan,2020,18414,22,2020-06-01,10139175,2059,20.307372148128422,7553,20.307372148128422
Azerbaijan,2020,18421,23,2020-06-08,10139175,2404,23.710015854347123,9957,23.710015854347123
Azerbaijan,2020,18428,24,2020-06-15,10139175,2772,27.33950247431374,12729,27.33950247431374
Azerbaijan,2020,18435,25,2020-06-22,10139175,3695,36.44280723037131,16424,36.44280723037131
Azerbaijan,2020,18442,26,2020-06-29,10139175,3900,38.46466798334184,20324,38.46466798334184
Azerbaijan,2020,18449,27,2020-07-06,10139175,3717,36.65978740873888,24041,36.65978740873888
Azerbaijan,2020,18456,28,2020-07-13,10139175,3480,34.32231912359733,27521,34.32231912359733
Azerbaijan,2020,18463,29,2020-07-20,10139175,2529,24.942857776890133,30050,24.942857776890133
Azerbaijan,2020,18470,30,2020-07-27,10139175,2393,23.601525765163338,32443,23.601525765163338
Azerbaijan,2020,18477,31,2020-08-03,10139175,1125,11.095577302887069,33568,11.095577302887069
Azerbaijan,2020,18484,32,2020-08-10,10139175,651,6.420640732603984,34219,6.420640732603984
Azerbaijan,2020,18491,33,2020-08-17,10139175,1055,10.405185826262985,35274,10.405185826262985
Azerbaijan,2020,18498,34,2020-08-24,10139175,1035,10.207931118656104,36309,10.207931118656104
Azerbaijan,2020,18505,35,2020-08-31,10139175,1020,10.059990087950943,37329,10.059990087950943
Azerbaijan,2020,18512,36,2020-09-07,10139175,998,9.843009909583373,38327,9.843009909583373
Azerbaijan,2020,18519,37,2020-09-14,10139175,861,8.491815162476238,39188,8.491815162476238
Azerbaijan,2020,18526,38,2020-09-21,10139175,835,8.235384042587292,40023,8.235384042587292
Azerbaijan,2020,18533,39,2020-09-28,10139175,668,6.588307234069833,40691,6.588307234069833
Azerbaijan,2020,18540,40,2020-10-05,10139175,1291,12.732791376024183,41982,12.732791376024183
Azerbaijan,2020,18547,41,2020-10-12,10139175,2982,29.41067690418599,44964,29.41067690418599
Azerbaijan,2020,18554,42,2020-10-19,10139175,4995,49.26436322481859,49959,49.26436322481859
Azerbaijan,2020,18561,43,2020-10-26,10139175,6485,63.95983894153124,56444,63.95983894153124
Azerbaijan,2020,18568,44,2020-11-02,10139175,8967,88.4391481555452,65411,88.4391481555452
Azerbaijan,2020,18575,45,2020-11-09,10139175,10277,101.35933150379591,75688,101.35933150379591
Azerbaijan,2020,18582,46,2020-11-16,10139175,17406,171.67077203026872,93094,171.67077203026872
Azerbaijan,2020,18589,47,2020-11-23,10139175,25101,247.5645207820163,118195,247.5645207820163
Azerbaijan,2020,18596,48,2020-11-30,10139175,28484,280.93015457372024,146679,280.93015457372024
Azerbaijan,2020,18603,49,2020-12-07,10139175,29195,287.94255942914486,175874,287.94255942914486
Azerbaijan,2020,18610,50,2020-12-14,10139175,26214,258.5417452603392,202088,258.5417452603392
Azerbaijan,2020,18617,51,2020-12-21,10139175,13395,132.1113404197087,215483,132.1113404197087
Azerbaijan,2020,18624,52,2020-12-28,10139175,4782,47.1636005888053,220265,47.1636005888053
Azerbaijan,2021,18631,0,2021-01-04,10139175,4562,44.99379880512961,224827,44.99379880512961
Azerbaijan,2021,18631,1,2021-01-04,10139175,2564,25.288053515202172,227391,25.288053515202172
Azerbaijan,2021,18638,2,2021-01-11,10139175,1641,16.184748759144604,229032,16.184748759144604
Azerbaijan,2021,18645,3,2021-01-18,10139175,1187,11.707066896468401,230219,11.707066896468401
Azerbaijan,2021,18652,4,2021-01-25,10139175,935,9.221657580621697,231154,9.221657580621697
Azerbaijan,2021,18659,5,2021-02-01,10139175,1043,10.286833001698856,232197,10.286833001698856
Azerbaijan,2021,18666,6,2021-02-08,10139175,1004,9.902186321865438,233201,9.902186321865438
Azerbaijan,2021,18673,7,2021-02-15,10139175,1461,14.409456390682674,234662,14.409456390682674
Azerbaijan,2021,18680,8,2021-02-22,10139175,2301,22.694154110171684,236963,22.694154110171684
Azerbaijan,2021,18687,9,2021-03-01,10139175,3332,32.86263428730641,240295,32.86263428730641
Azerbaijan,2021,18694,10,2021-03-08,10139175,6679,65.87320960531798,246974,65.87320960531798
Azerbaijan,2021,18701,11,2021-03-15,10139175,10356,102.1384875988431,257330,102.1384875988431
Azerbaijan,2021,18708,12,2021-03-22,10139175,14504,143.04911395651027,271834,143.04911395651027
Azerbaijan,2021,18715,13,2021-03-29,10139175,15310,150.99847867306758,287144,150.99847867306758
Azerbaijan,2021,18722,14,2021-04-05,10139175,14517,143.17732951645473,301661,143.17732951645473
Azerbaijan,2021,18729,15,2021-04-12,10139175,12151,119.84209760656069,313812,119.84209760656069
Azerbaijan,2021,18736,16,2021-04-19,10139175,7986,78.76380474742767,321798,78.76380474742767
Azerbaijan,2021,18743,17,2021-04-26,10139175,5289,52.16400742663974,327087,52.16400742663974
Azerbaijan,2021,18750,18,2021-05-03,10139175,3182,31.383223980254805,330269,31.383223980254805
Azerbaijan,2021,18757,19,2021-05-10,10139175,2185,21.550076806051774,332454,21.550076806051774
Azerbaijan,2021,18764,20,2021-05-17,10139175,1410,13.906456886285127,333864,13.906456886285127
Azerbaijan,2021,18771,21,2021-05-24,10139175,851,8.393187808672796,334715,8.393187808672796
Azerbaijan,2021,18778,22,2021-05-31,10139175,456,4.497407333436892,335171,4.497407333436892
Azerbaijan,2021,18785,23,2021-06-07,10139175,322,3.175800792470788,335493,3.175800792470788
Azerbaijan,2021,18792,24,2021-06-14,10139175,343,3.382918235458013,335836,3.382918235458013
Azerbaijan,2021,18799,25,2021-06-21,10139175,581,5.7302492559799,336417,5.7302492559799
Azerbaijan,2021,18806,26,2021-06-28,10139175,837,8.25510951334798,337254,8.25510951334798
Azerbaijan,2021,18813,27,2021-07-05,10139175,1332,13.13716352661829,338586,13.13716352661829
Azerbaijan,2021,18820,28,2021-07-12,10139175,1857,18.315099601298922,340443,18.315099601298922
Azerbaijan,2021,18827,29,2021-07-19,10139175,4077,40.21037214566274,344520,40.21037214566274
Azerbaijan,2021,18834,30,2021-07-26,10139175,7305,72.04728195341337,351825,72.04728195341337
Azerbaijan,2021,18841,31,2021-08-02,10139175,16177,159.5494702478259,368002,159.5494702478259
Azerbaijan,2021,18848,32,2021-08-09,10139175,23504,231.81373237960682,391506,231.81373237960682
Azerbaijan,2021,18855,33,2021-08-16,10139175,26490,261.2638602253142,417996,261.2638602253142
Azerbaijan,2021,18862,34,2021-08-23,10139175,24876,245.34540532143888,442872,245.34540532143888
Azerbaijan,2021,18869,35,2021-08-30,10139175,17220,169.83630324952475,460092,169.83630324952475
Azerbaijan,2021,18876,36,2021-09-06,10139175,12627,124.53675964760447,472719,124.53675964760447
Azerbaijan,2021,18883,37,2021-09-13,10139175,8124,80.12486222991515,480843,80.12486222991515
Azerbaijan,2021,18890,38,2021-09-20,10139175,5535,54.59024033020438,486378,54.59024033020438
Azerbaijan,2021,18897,39,2021-09-27,10139175,5801,57.2137279413759,492179,57.2137279413759
Azerbaijan,2021,18904,40,2021-10-04,10139175,10028,98.90351039409025,502207,98.90351039409025
Azerbaijan,2021,18911,41,2021-10-11,10139175,14118,139.24209809969747,516325,139.24209809969747
Azerbaijan,2021,18918,42,2021-10-18,10139175,15045,148.3848537972764,531370,148.3848537972764
Azerbaijan,2021,18925,43,2021-10-25,10139175,15911,156.92598263665437,547281,156.92598263665437
Belarus,2020,18267,0,2020-01-06,9449321,0,0,0,0
Belarus,2020,18267,1,2020-01-06,9449321,0,0,0,0
Belarus,2020,18274,2,2020-01-13,9449321,0,0,0,0
Belarus,2020,18281,3,2020-01-20,9449321,0,0,0,0
Belarus,2020,18288,4,2020-01-27,9449321,0,0,0,0
Belarus,2020,18295,5,2020-02-03,9449321,0,0,0,0
Belarus,2020,18302,6,2020-02-10,9449321,0,0,0,0
Belarus,2020,18309,7,2020-02-17,9449321,0,0,0,0
Belarus,2020,18316,8,2020-02-24,9449321,1,0.010582770973702766,1,0.010582770973702766
Belarus,2020,18323,9,2020-03-02,9449321,5,0.052913854868513834,6,0.052913854868513834
Belarus,2020,18330,10,2020-03-09,9449321,21,0.2222381904477581,27,0.2222381904477581
Belarus,2020,18337,11,2020-03-16,9449321,49,0.5185557777114356,76,0.5185557777114356
Belarus,2020,18344,12,2020-03-23,9449321,18,0.1904898775266498,94,0.1904898775266498
Belarus,2020,18351,13,2020-03-30,9449321,470,4.9739023576403,564,4.9739023576403
Belarus,2020,18358,14,2020-04-06,9449321,2014,21.313700741037373,2578,21.313700741037373
Belarus,2020,18365,15,2020-04-13,9449321,3229,34.17176747408623,5807,34.17176747408623
Belarus,2020,18372,16,2020-04-20,9449321,4656,49.27338165356008,10463,49.27338165356008
Belarus,2020,18379,17,2020-04-27,9449321,6242,66.05765641785267,16705,66.05765641785267
Belarus,2020,18386,18,2020-05-04,9449321,6268,66.33280846316894,22973,66.33280846316894
Belarus,2020,18393,19,2020-05-11,9449321,6677,70.66116179141338,29650,70.66116179141338
Belarus,2020,18400,20,2020-05-18,9449321,6548,69.29598433580571,36198,69.29598433580571
Belarus,2020,18407,21,2020-05-25,9449321,6358,67.2852578508022,42556,67.2852578508022
Belarus,2020,18414,22,2020-06-01,9449321,6074,64.2797508942706,48630,64.2797508942706
Belarus,2020,18421,23,2020-06-08,9449321,5343,56.54374531249388,53973,56.54374531249388
Belarus,2020,18428,24,2020-06-15,9449321,4532,47.961118052820936,58505,47.961118052820936
Belarus,2020,18435,25,2020-06-22,9449321,2970,31.430829791897217,61475,31.430829791897217
Belarus,2020,18442,26,2020-06-29,9449321,2079,22.00158085432805,63554,22.00158085432805
Belarus,2020,18449,27,2020-07-06,9449321,1378,14.583058401762413,64932,14.583058401762413
Belarus,2020,18456,28,2020-07-13,9449321,1163,12.307762642416318,66095,12.307762642416318
Belarus,2020,18463,29,2020-07-20,9449321,1037,10.974333499729768,67132,10.974333499729768
Belarus,2020,18470,30,2020-07-27,9449321,935,9.894890860412087,68067,9.894890860412087
Belarus,2020,18477,31,2020-08-03,9449321,783,8.286309672409267,68850,8.286309672409267
Belarus,2020,18484,32,2020-08-10,9449321,666,7.048125468486043,69516,7.048125468486043
Belarus,2020,18491,33,2020-08-17,9449321,952,10.074797966965034,70468,10.074797966965034
Belarus,2020,18498,34,2020-08-24,9449321,1219,12.900397816943672,71687,12.900397816943672
Belarus,2020,18505,35,2020-08-31,9449321,1172,12.403007581179642,72859,12.403007581179642
Belarus,2020,18512,36,2020-09-07,9449321,1314,13.905761059445435,74173,13.905761059445435
Belarus,2020,18519,37,2020-09-14,9449321,1501,15.884739231527853,75674,15.884739231527853
Belarus,2020,18526,38,2020-09-21,9449321,1935,20.477661834114855,77609,20.477661834114855
Belarus,2020,18533,39,2020-09-28,9449321,2686,28.42532283536563,80295,28.42532283536563
Belarus,2020,18540,40,2020-10-05,9449321,3239,34.27759518382326,83534,34.27759518382326
Belarus,2020,18547,41,2020-10-12,9449321,4164,44.06665833449832,87698,44.06665833449832
Belarus,2020,18554,42,2020-10-19,9449321,5125,54.23670124022668,92823,54.23670124022668
Belarus,2020,18561,43,2020-10-26,9449321,6636,70.22726818149155,99459,70.22726818149155
Belarus,2020,18568,44,2020-11-02,9449321,6820,72.17449804065286,106279,72.17449804065286
Belarus,2020,18575,45,2020-11-09,9449321,7906,83.66738731809407,114185,83.66738731809407
Belarus,2020,18582,46,2020-11-16,9449321,9814,103.85931433591895,123999,103.85931433591895
Belarus,2020,18589,47,2020-11-23,9449321,11009,116.50572564949375,135008,116.50572564949375
Belarus,2020,18596,48,2020-11-30,9449321,12149,128.57008455951492,147157,128.57008455951492
Belarus,2020,18603,49,2020-12-07,9449321,13138,139.03644505250693,160295,139.03644505250693
Belarus,2020,18610,50,2020-12-14,9449321,13228,139.9888944401402,173523,139.9888944401402
Belarus,2020,18617,51,2020-12-21,9449321,15065,159.42944471883217,188588,159.42944471883217
Belarus,2020,18624,52,2020-12-28,9449321,11374,120.36843705489527,199962,120.36843705489527
Belarus,2021,18631,0,2021-01-04,9449321,14031,148.48685953202352,213993,148.48685953202352
Belarus,2021,18631,1,2021-01-04,9449321,13367,141.45989960548488,227360,141.45989960548488
Belarus,2021,18638,2,2021-01-11,9449321,10251,108.48398525142706,237611,108.48398525142706
Belarus,2021,18645,3,2021-01-18,9449321,10725,113.50021869296218,248336,113.50021869296218
Belarus,2021,18652,4,2021-01-25,9449321,10163,107.55270140574122,258499,107.55270140574122
Belarus,2021,18659,5,2021-02-01,9449321,10188,107.81727068008378,268687,107.81727068008378
Belarus,2021,18666,6,2021-02-08,9449321,10769,113.9658606158051,279456,113.9658606158051
Belarus,2021,18673,7,2021-02-15,9449321,8811,93.24479504929508,288267,93.24479504929508
Belarus,2021,18680,8,2021-02-22,9449321,8174,86.50356993904641,296441,86.50356993904641
Belarus,2021,18687,9,2021-03-01,9449321,5882,62.24785886731967,302323,62.24785886731967
Belarus,2021,18694,10,2021-03-08,9449321,8122,85.95326584841386,310445,85.95326584841386
Belarus,2021,18701,11,2021-03-15,9449321,8236,87.15970173941598,318681,87.15970173941598
Belarus,2021,18708,12,2021-03-22,9449321,8623,91.25523410623896,327304,91.25523410623896
Belarus,2021,18715,13,2021-03-29,9449321,9577,101.35119761515139,336881,101.35119761515139
Belarus,2021,18722,14,2021-04-05,9449321,7342,77.69870448892571,344223,77.69870448892571
Belarus,2021,18729,15,2021-04-12,9449321,9623,101.83800507994172,353846,101.83800507994172
Belarus,2021,18736,16,2021-04-19,9449321,8051,85.20188910928097,361897,85.20188910928097
Belarus,2021,18743,17,2021-04-26,9449321,6991,73.98415187715604,368888,73.98415187715604
Belarus,2021,18750,18,2021-05-03,9449321,8644,91.47747229668671,377532,91.47747229668671
Belarus,2021,18757,19,2021-05-10,9449321,8493,89.8794738796576,386025,89.8794738796576
Belarus,2021,18764,20,2021-05-17,9449321,8414,89.04343497273508,394439,89.04343497273508
Belarus,2021,18771,21,2021-05-24,9449321,5983,63.31671873566365,400422,63.31671873566365
Belarus,2021,18778,22,2021-05-31,9449321,5241,55.4643026731762,405663,55.4643026731762
Belarus,2021,18785,23,2021-06-07,9449321,5490,58.09941264562819,411153,58.09941264562819
Belarus,2021,18792,24,2021-06-14,9449321,4627,48.9664812953227,415780,48.9664812953227
Belarus,2021,18799,25,2021-06-21,9449321,5570,58.94603432352441,421350,58.94603432352441
Belarus,2021,18806,26,2021-06-28,9449321,7245,76.67217570447654,428595,76.67217570447654
Belarus,2021,18813,27,2021-07-05,9449321,6425,67.99430350604028,435020,67.99430350604028
Belarus,2021,18820,28,2021-07-12,9449321,6336,67.05243688938073,441356,67.05243688938073
Belarus,2021,18827,29,2021-07-19,9449321,6398,67.7085686897503,447754,67.7085686897503
Belarus,2021,18834,30,2021-07-26,9449321,6920,73.23277513802314,454674,73.23277513802314
Belarus,2021,18841,31,2021-08-02,9449321,7523,79.61418603516591,462197,79.61418603516591
Belarus,2021,18848,32,2021-08-09,9449321,8438,89.29742147610395,470635,89.29742147610395
Belarus,2021,18855,33,2021-08-16,9449321,9729,102.95977880315422,480364,102.95977880315422
Belarus,2021,18862,34,2021-08-23,9449321,12035,127.3636486685128,492399,127.3636486685128
Belarus,2021,18869,35,2021-08-30,9449321,10674,112.96049737330333,503073,112.96049737330333
Belarus,2021,18876,36,2021-09-06,9449321,15296,161.8740648137575,518369,161.8740648137575
Belarus,2021,18883,37,2021-09-13,9449321,13780,145.83058401762412,532149,145.83058401762412
Belarus,2021,18890,38,2021-09-20,9449321,11827,125.16243230598262,543976,125.16243230598262
Belarus,2021,18897,39,2021-09-27,9449321,15739,166.56223235510785,559715,166.56223235510785
Belarus,2021,18904,40,2021-10-04,9449321,14228,150.57166541384296,573943,150.57166541384296
Belarus,2021,18911,41,2021-10-11,9449321,14288,151.20663167226513,588231,151.20663167226513
Belarus,2021,18918,42,2021-10-18,9449321,13827,146.32797425338816,602058,146.32797425338816
Belarus,2021,18925,43,2021-10-25,9449321,13756,145.57659751425527,615814,145.57659751425527
Belgium,2020,18267,0,2020-01-06,11522440,0,0,0,0
Belgium,2020,18267,1,2020-01-06,11522440,0,0,0,0
Belgium,2020,18274,2,2020-01-13,11522440,0,0,0,0
Belgium,2020,18281,3,2020-01-20,11522440,0,0,0,0
Belgium,2020,18288,4,2020-01-27,11522440,2,0.017357434710009337,2,0.017357434710009337
Belgium,2020,18295,5,2020-02-03,11522440,0,0,2,0
Belgium,2020,18302,6,2020-02-10,11522440,0,0,2,0
Belgium,2020,18309,7,2020-02-17,11522440,0,0,2,0
Belgium,2020,18316,8,2020-02-24,11522440,0,0,2,0
Belgium,2020,18323,9,2020-03-02,11522440,0,0,2,0
Belgium,2020,18330,10,2020-03-09,11522440,3678,31.920322431707174,3680,31.920322431707174
Belgium,2020,18337,11,2020-03-16,11522440,3673,31.87692884493215,7353,31.87692884493215
Belgium,2020,18344,12,2020-03-23,11522440,8130,70.55797209618797,15483,70.55797209618797
Belgium,2020,18351,13,2020-03-30,11522440,9694,84.13148603941526,25177,84.13148603941526
Belgium,2020,18358,14,2020-04-06,11522440,11175,96.98466644217717,36352,96.98466644217717
Belgium,2020,18365,15,2020-04-13,11522440,7963,69.10862629790218,44315,69.10862629790218
Belgium,2020,18372,16,2020-04-20,11522440,5703,49.49472507559163,50018,49.49472507559163
Belgium,2020,18379,17,2020-04-27,11522440,3095,26.86063021373945,53113,26.86063021373945
Belgium,2020,18386,18,2020-05-04,11522440,3051,26.478766650119244,56164,26.478766650119244
Belgium,2020,18393,19,2020-05-11,11522440,2071,17.97362364221467,58235,17.97362364221467
Belgium,2020,18400,20,2020-05-18,11522440,1510,13.10486320605705,59745,13.10486320605705
Belgium,2020,18407,21,2020-05-25,11522440,1144,9.928452654125342,60889,9.928452654125342
Belgium,2020,18414,22,2020-06-01,11522440,847,7.3508735996889545,61736,7.3508735996889545
Belgium,2020,18421,23,2020-06-08,11522440,671,5.823419345208133,62407,5.823419345208133
Belgium,2020,18428,24,2020-06-15,11522440,668,5.797383193143119,63075,5.797383193143119
Belgium,2020,18435,25,2020-06-22,11522440,607,5.267981434487834,63682,5.267981434487834
Belgium,2020,18442,26,2020-06-29,11522440,637,5.528342955137974,64319,5.528342955137974
Belgium,2020,18449,27,2020-07-06,11522440,704,6.109817017923287,65023,6.109817017923287
Belgium,2020,18456,28,2020-07-13,11522440,1385,12.020023536681467,66408,12.020023536681467
Belgium,2020,18463,29,2020-07-20,11522440,2489,21.601327496606622,68897,21.601327496606622
Belgium,2020,18470,30,2020-07-27,11522440,3759,32.62329853746255,72656,32.62329853746255
Belgium,2020,18477,31,2020-08-03,11522440,4340,37.66563332072026,76996,37.66563332072026
Belgium,2020,18484,32,2020-08-10,11522440,3751,32.55386879862252,80747,32.55386879862252
Belgium,2020,18491,33,2020-08-17,11522440,3453,29.967611026831122,84200,29.967611026831122
Belgium,2020,18498,34,2020-08-24,11522440,3121,27.086276864969573,87321,27.086276864969573
Belgium,2020,18505,35,2020-08-31,11522440,3655,31.720711932542066,90976,31.720711932542066
Belgium,2020,18512,36,2020-09-07,11522440,6158,53.44354147211875,97134,53.44354147211875
Belgium,2020,18519,37,2020-09-14,11522440,10108,87.72447502438719,107242,87.72447502438719
Belgium,2020,18526,38,2020-09-21,11522440,11274,97.84385946032263,118516,97.84385946032263
Belgium,2020,18533,39,2020-09-28,11522440,18895,163.98436442281323,137411,163.98436442281323
Belgium,2020,18540,40,2020-10-05,11522440,38852,337.1855266766414,176263,337.1855266766414
Belgium,2020,18547,41,2020-10-12,11522440,72232,626.8811119866973,248495,626.8811119866973
Belgium,2020,18554,42,2020-10-19,11522440,105383,914.5892710224571,353878,914.5892710224571
Belgium,2020,18561,43,2020-10-26,11522440,99584,864.261389080785,453462,864.261389080785
Belgium,2020,18568,44,2020-11-02,11522440,54006,468.70280947438215,507468,468.70280947438215
Belgium,2020,18575,45,2020-11-09,11522440,33967,294.7899923974436,541435,294.7899923974436
Belgium,2020,18582,46,2020-11-16,11522440,22312,193.63954162486417,563747,193.63954162486417
Belgium,2020,18589,47,2020-11-23,11522440,16261,141.12462290973093,580008,141.12462290973093
Belgium,2020,18596,48,2020-11-30,11522440,15289,132.6889096406664,595297,132.6889096406664
Belgium,2020,18603,49,2020-12-07,11522440,16840,146.14960025827864,612137,146.14960025827864
Belgium,2020,18610,50,2020-12-14,11522440,17714,153.7347992265527,629851,153.7347992265527
Belgium,2020,18617,51,2020-12-21,11522440,12607,109.41258969454387,642458,109.41258969454387
Belgium,2020,18624,52,2020-12-28,11522440,8976,77.90016697852191,651434,77.90016697852191
Belgium,2021,18631,0,2021-01-04,11522440,14921,129.49514165402468,666355,129.49514165402468
Belgium,2021,18631,1,2021-01-04,11522440,14183,123.09024824603122,680538,123.09024824603122
Belgium,2021,18638,2,2021-01-11,11522440,15424,133.86053648359203,695962,133.86053648359203
Belgium,2021,18645,3,2021-01-18,11522440,16998,147.52083760036936,712960,147.52083760036936
Belgium,2021,18652,4,2021-01-25,11522440,15377,133.4526367679068,728337,133.4526367679068
Belgium,2021,18659,5,2021-02-01,11522440,12932,112.23317283492038,741269,112.23317283492038
Belgium,2021,18666,6,2021-02-08,11522440,15661,135.91739249672813,756930,135.91739249672813
Belgium,2021,18673,7,2021-02-15,11522440,16955,147.14765275410417,773885,147.14765275410417
Belgium,2021,18680,8,2021-02-22,11522440,16703,144.96061598064298,790588,144.96061598064298
Belgium,2021,18687,9,2021-03-01,11522440,21554,187.06107386977064,812142,187.06107386977064
Belgium,2021,18694,10,2021-03-08,11522440,29615,257.0202144684633,841757,257.0202144684633
Belgium,2021,18701,11,2021-03-15,11522440,34289,297.5845393857551,876046,297.5845393857551
Belgium,2021,18708,12,2021-03-22,11522440,30214,262.21876616411106,906260,262.21876616411106
Belgium,2021,18715,13,2021-03-29,11522440,24438,212.0904947216041,930698,212.0904947216041
Belgium,2021,18722,14,2021-04-05,11522440,24656,213.98245510499513,955354,213.98245510499513
Belgium,2021,18729,15,2021-04-12,11522440,24690,214.2775314950653,980044,214.2775314950653
Belgium,2021,18736,16,2021-04-19,11522440,21022,182.44399623690816,1001066,182.44399623690816
Belgium,2021,18743,17,2021-04-26,11522440,21233,184.27520559881415,1022299,184.27520559881415
Belgium,2021,18750,18,2021-05-03,11522440,14914,129.43439063253965,1037213,129.43439063253965
Belgium,2021,18757,19,2021-05-10,11522440,17300,150.14181024158077,1054513,150.14181024158077
Belgium,2021,18764,20,2021-05-17,11522440,12233,106.16674940377212,1066746,106.16674940377212
Belgium,2021,18771,21,2021-05-24,11522440,9119,79.14122356028757,1075865,79.14122356028757
Belgium,2021,18778,22,2021-05-31,11522440,5282,45.84098506913466,1081147,45.84098506913466
Belgium,2021,18785,23,2021-06-07,11522440,3028,26.279156150954137,1084175,26.279156150954137
Belgium,2021,18792,24,2021-06-14,11522440,2458,21.332287258601475,1086633,21.332287258601475
Belgium,2021,18799,25,2021-06-21,11522440,4091,35.5046326993241,1090724,35.5046326993241
Belgium,2021,18806,26,2021-06-28,11522440,7512,65.19452477079507,1098236,65.19452477079507
Belgium,2021,18813,27,2021-07-05,11522440,9543,82.82099971880956,1107779,82.82099971880956
Belgium,2021,18820,28,2021-07-12,11522440,10391,90.18055203585352,1118170,90.18055203585352
Belgium,2021,18827,29,2021-07-19,11522440,11284,97.93064663387268,1129454,97.93064663387268
Belgium,2021,18834,30,2021-07-26,11522440,12236,106.19278555583713,1141690,106.19278555583713
Belgium,2021,18841,31,2021-08-02,11522440,13354,115.89559155873235,1155044,115.89559155873235
Belgium,2021,18848,32,2021-08-09,11522440,13831,120.03533973706958,1168875,120.03533973706958
Belgium,2021,18855,33,2021-08-16,11522440,14113,122.4827380311809,1182988,122.4827380311809
Belgium,2021,18862,34,2021-08-23,11522440,13758,119.40179337015424,1196746,119.40179337015424
Belgium,2021,18869,35,2021-08-30,11522440,13755,119.37575721808922,1210501,119.37575721808922
Belgium,2021,18876,36,2021-09-06,11522440,14471,125.58971884427257,1224972,125.58971884427257
Belgium,2021,18883,37,2021-09-13,11522440,13640,118.37770472226369,1238612,118.37770472226369
Belgium,2021,18890,38,2021-09-20,11522440,13305,115.47033440833712,1251917,115.47033440833712
Belgium,2021,18897,39,2021-09-27,11522440,14912,129.41703319782962,1266829,129.41703319782962
Belgium,2021,18904,40,2021-10-04,11522440,22846,198.27397669243666,1289675,198.27397669243666
Belgium,2021,18911,41,2021-10-11,11522440,39975,346.93172626631167,1329650,346.93172626631167
Belgium,2021,18918,42,2021-10-18,11522440,54842,475.9582171831661,1384492,475.9582171831661
Belgium,2021,18925,43,2021-10-25,11522440,57768,501.3521441639097,1442260,501.3521441639097
Bosnia And Herzegovina,2020,18330,10,2020-03-09,3280815,18,0.5486441631119097,18,0.5486441631119097
Bosnia And Herzegovina,2020,18337,11,2020-03-16,3280815,113,3.444266135091433,131,3.444266135091433
Bosnia And Herzegovina,2020,18344,12,2020-03-23,3280815,221,6.736131113762891,352,6.736131113762891
Bosnia And Herzegovina,2020,18351,13,2020-03-30,3280815,296,9.022148460062516,648,9.022148460062516
Bosnia And Herzegovina,2020,18358,14,2020-04-06,3280815,352,10.729041411966234,1000,10.729041411966234
Bosnia And Herzegovina,2020,18365,15,2020-04-13,3280815,285,8.68686591593857,1285,8.68686591593857
Bosnia And Herzegovina,2020,18372,16,2020-04-20,3280815,231,7.040933426602841,1516,7.040933426602841
Bosnia And Herzegovina,2020,18379,17,2020-04-27,3280815,341,10.393758867842289,1857,10.393758867842289
Bosnia And Herzegovina,2020,18386,18,2020-05-04,3280815,260,7.9248601338386955,2117,7.9248601338386955
Bosnia And Herzegovina,2020,18393,19,2020-05-11,3280815,173,5.273080012131132,2290,5.273080012131132
Bosnia And Herzegovina,2020,18400,20,2020-05-18,3280815,111,3.383305672523443,2401,3.383305672523443
Bosnia And Herzegovina,2020,18407,21,2020-05-25,3280815,109,3.3223452099554533,2510,3.3223452099554533
Bosnia And Herzegovina,2020,18414,22,2020-06-01,3280815,164,4.998757930575177,2674,4.998757930575177
Bosnia And Herzegovina,2020,18421,23,2020-06-08,3280815,328,9.997515861150355,3002,9.997515861150355
Bosnia And Herzegovina,2020,18428,24,2020-06-15,3280815,430,13.106499452117843,3432,13.106499452117843
Bosnia And Herzegovina,2020,18435,25,2020-06-22,3280815,774,23.591699013812118,4206,23.591699013812118
Bosnia And Herzegovina,2020,18442,26,2020-06-29,3280815,1188,36.21051476538604,5394,36.21051476538604
Bosnia And Herzegovina,2020,18449,27,2020-07-06,3280815,1490,45.41554461315253,6884,45.41554461315253
Bosnia And Herzegovina,2020,18456,28,2020-07-13,3280815,1568,47.793002653304136,8452,47.793002653304136
Bosnia And Herzegovina,2020,18463,29,2020-07-20,3280815,1863,56.78467088208265,10315,56.78467088208265
Bosnia And Herzegovina,2020,18470,30,2020-07-27,3280815,1857,56.601789494378686,12172,56.601789494378686
Bosnia And Herzegovina,2020,18477,31,2020-08-03,3280815,2153,65.6239379544412,14325,65.6239379544412
Bosnia And Herzegovina,2020,18484,32,2020-08-10,3280815,1684,51.328709482247554,16009,51.328709482247554
Bosnia And Herzegovina,2020,18491,33,2020-08-17,3280815,1893,57.699077820602504,17902,57.699077820602504
Bosnia And Herzegovina,2020,18498,34,2020-08-24,3280815,1891,57.63811735803451,19793,57.63811735803451
Bosnia And Herzegovina,2020,18505,35,2020-08-31,3280815,1767,53.85856867881913,21560,53.85856867881913
Bosnia And Herzegovina,2020,18512,36,2020-09-07,3280815,1907,58.12580105857843,23467,58.12580105857843
Bosnia And Herzegovina,2020,18519,37,2020-09-14,3280815,1962,59.802213779198155,25429,59.802213779198155
Bosnia And Herzegovina,2020,18526,38,2020-09-21,3280815,1492,45.47650507572052,26921,45.47650507572052
Bosnia And Herzegovina,2020,18533,39,2020-09-28,3280815,1384,42.184640097049055,28305,42.184640097049055
Bosnia And Herzegovina,2020,18540,40,2020-10-05,3280815,2342,71.38470166711625,30647,71.38470166711625
Bosnia And Herzegovina,2020,18547,41,2020-10-12,3280815,3469,105.7359223241786,34116,105.7359223241786
Bosnia And Herzegovina,2020,18554,42,2020-10-19,3280815,6777,206.564527411634,40893,206.564527411634
Bosnia And Herzegovina,2020,18561,43,2020-10-26,3280815,10612,323.4562143857548,51505,323.4562143857548
Bosnia And Herzegovina,2020,18568,44,2020-11-02,3280815,10918,332.7831651586572,62423,332.7831651586572
Bosnia And Herzegovina,2020,18575,45,2020-11-09,3280815,9533,290.5680448303242,71956,290.5680448303242
Bosnia And Herzegovina,2020,18582,46,2020-11-16,3280815,8050,245.3658618361596,80006,245.3658618361596
Bosnia And Herzegovina,2020,18589,47,2020-11-23,3280815,7268,221.53032097207554,87274,221.53032097207554
Bosnia And Herzegovina,2020,18596,48,2020-11-30,3280815,7233,220.4635128771357,94507,220.4635128771357
Bosnia And Herzegovina,2020,18603,49,2020-12-07,3280815,6610,201.47432878720684,101117,201.47432878720684
Bosnia And Herzegovina,2020,18610,50,2020-12-14,3280815,4889,149.01785074745146,106006,149.01785074745146
Bosnia And Herzegovina,2020,18617,51,2020-12-21,3280815,3685,112.31965228152151,109691,112.31965228152151
Bosnia And Herzegovina,2020,18624,52,2020-12-28,3280815,2954,90.03860321292117,112645,90.03860321292117
Bosnia And Herzegovina,2021,18631,0,2021-01-04,3280815,2988,91.07493107657702,115633,91.07493107657702
Bosnia And Herzegovina,2021,18631,1,2021-01-04,3280815,2340,71.32374120454826,117973,71.32374120454826
Bosnia And Herzegovina,2021,18638,2,2021-01-11,3280815,2070,63.09407875786962,120043,63.09407875786962
Bosnia And Herzegovina,2021,18645,3,2021-01-18,3280815,2043,62.27111251320175,122086,62.27111251320175
Bosnia And Herzegovina,2021,18652,4,2021-01-25,3280815,1858,56.63226972566268,123944,56.63226972566268
Bosnia And Herzegovina,2021,18659,5,2021-02-01,3280815,2079,63.36840083942557,126023,63.36840083942557
Bosnia And Herzegovina,2021,18666,6,2021-02-08,3280815,2295,69.95213079676849,128318,69.95213079676849
Bosnia And Herzegovina,2021,18673,7,2021-02-15,3280815,3820,116.43448350486084,132138,116.43448350486084
Bosnia And Herzegovina,2021,18680,8,2021-02-22,3280815,4760,145.0859009118161,136898,145.0859009118161
Bosnia And Herzegovina,2021,18687,9,2021-03-01,3280815,7351,224.06018016864712,144249,224.06018016864712
Bosnia And Herzegovina,2021,18694,10,2021-03-08,3280815,9560,291.39101107499204,153809,291.39101107499204
Bosnia And Herzegovina,2021,18701,11,2021-03-15,3280815,11122,339.0011323405922,164931,339.0011323405922
Bosnia And Herzegovina,2021,18708,12,2021-03-22,3280815,10846,330.5885885062096,175777,330.5885885062096
Bosnia And Herzegovina,2021,18715,13,2021-03-29,3280815,8477,258.38092059442545,184254,258.38092059442545
Bosnia And Herzegovina,2021,18722,14,2021-04-05,3280815,6513,198.51774635265932,190767,198.51774635265932
Bosnia And Herzegovina,2021,18729,15,2021-04-12,3280815,5024,153.1326819707908,195791,153.1326819707908
Bosnia And Herzegovina,2021,18736,16,2021-04-19,3280815,3148,95.9517680820162,198939,95.9517680820162
Bosnia And Herzegovina,2021,18743,17,2021-04-26,3280815,2177,66.35546350525708,201116,66.35546350525708
Bosnia And Herzegovina,2021,18750,18,2021-05-03,3280815,1303,39.71574136304546,202419,39.71574136304546
Bosnia And Herzegovina,2021,18757,19,2021-05-10,3280815,917,27.9503720874234,203336,27.9503720874234
Bosnia And Herzegovina,2021,18764,20,2021-05-17,3280815,642,19.568308484324778,203978,19.568308484324778
Bosnia And Herzegovina,2021,18771,21,2021-05-24,3280815,408,12.435934363869952,204386,12.435934363869952
Bosnia And Herzegovina,2021,18778,22,2021-05-31,3280815,276,8.412543834382616,204662,8.412543834382616
Bosnia And Herzegovina,2021,18785,23,2021-06-07,3280815,189,5.760763712675052,204851,5.760763712675052
Bosnia And Herzegovina,2021,18792,24,2021-06-14,3280815,133,4.053870760771333,204984,4.053870760771333
Bosnia And Herzegovina,2021,18799,25,2021-06-21,3280815,80,2.438418502719599,205064,2.438418502719599
Bosnia And Herzegovina,2021,18806,26,2021-06-28,3280815,106,3.230904516103468,205170,3.230904516103468
Bosnia And Herzegovina,2021,18813,27,2021-07-05,3280815,108,3.291864978671458,205278,3.291864978671458
Bosnia And Herzegovina,2021,18820,28,2021-07-12,3280815,204,6.217967181934976,205482,6.217967181934976
Bosnia And Herzegovina,2021,18827,29,2021-07-19,3280815,303,9.23551007905048,205785,9.23551007905048
Bosnia And Herzegovina,2021,18834,30,2021-07-26,3280815,532,16.21548304308533,206317,16.21548304308533
Bosnia And Herzegovina,2021,18841,31,2021-08-02,3280815,1254,38.22221003012971,207571,38.22221003012971
Bosnia And Herzegovina,2021,18848,32,2021-08-09,3280815,2338,71.26278074198027,209909,71.26278074198027
Bosnia And Herzegovina,2021,18855,33,2021-08-16,3280815,3470,105.76640255546259,213379,105.76640255546259
Bosnia And Herzegovina,2021,18862,34,2021-08-23,3280815,3983,121.40276120415201,217362,121.40276120415201
Bosnia And Herzegovina,2021,18869,35,2021-08-30,3280815,3274,99.79227722379957,220636,99.79227722379957
Bosnia And Herzegovina,2021,18876,36,2021-09-06,3280815,6943,211.62424580477716,227579,211.62424580477716
Bosnia And Herzegovina,2021,18883,37,2021-09-13,3280815,4658,141.97691732084863,232237,141.97691732084863
Bosnia And Herzegovina,2021,18890,38,2021-09-20,3280815,4780,145.69550553749602,237017,145.69550553749602
Bosnia And Herzegovina,2021,18897,39,2021-09-27,3280815,4210,128.32177370561888,241227,128.32177370561888
Bosnia And Herzegovina,2021,18904,40,2021-10-04,3280815,3855,117.50129159980067,245082,117.50129159980067
Bosnia And Herzegovina,2021,18911,41,2021-10-11,3280815,4267,130.0591468888066,249349,130.0591468888066
Bosnia And Herzegovina,2021,18918,42,2021-10-18,3280815,4999,152.3706761886909,254348,152.3706761886909
Bosnia And Herzegovina,2021,18925,43,2021-10-25,3280815,5565,169.6224870954321,259913,169.6224870954321
Bulgaria,2020,18267,0,2020-01-06,6951482,0,0,0,0
Bulgaria,2020,18267,1,2020-01-06,6951482,0,0,0,0
Bulgaria,2020,18274,2,2020-01-13,6951482,0,0,0,0
Bulgaria,2020,18281,3,2020-01-20,6951482,0,0,0,0
Bulgaria,2020,18288,4,2020-01-27,6951482,0,0,0,0
Bulgaria,2020,18295,5,2020-02-03,6951482,0,0,0,0
Bulgaria,2020,18302,6,2020-02-10,6951482,0,0,0,0
Bulgaria,2020,18309,7,2020-02-17,6951482,0,0,0,0
Bulgaria,2020,18316,8,2020-02-24,6951482,0,0,0,0
Bulgaria,2020,18323,9,2020-03-02,6951482,4,0.057541686794269194,4,0.057541686794269194
Bulgaria,2020,18330,10,2020-03-09,6951482,47,0.676114819832663,51,0.676114819832663
Bulgaria,2020,18337,11,2020-03-16,6951482,134,1.927646507608018,185,1.927646507608018
Bulgaria,2020,18344,12,2020-03-23,6951482,161,2.316052893469335,346,2.316052893469335
Bulgaria,2020,18351,13,2020-03-30,6951482,185,2.6613030142349503,531,2.6613030142349503
Bulgaria,2020,18358,14,2020-04-06,6951482,144,2.071500724593691,675,2.071500724593691
Bulgaria,2020,18365,15,2020-04-13,6951482,219,3.1504073519862383,894,3.1504073519862383
Bulgaria,2020,18372,16,2020-04-20,6951482,406,5.840481209618323,1300,5.840481209618323
Bulgaria,2020,18379,17,2020-04-27,6951482,318,4.574564100144401,1618,4.574564100144401
Bulgaria,2020,18386,18,2020-05-04,6951482,347,4.991741329402853,1965,4.991741329402853
Bulgaria,2020,18393,19,2020-05-11,6951482,246,3.5388137378475553,2211,3.5388137378475553
Bulgaria,2020,18400,20,2020-05-18,6951482,216,3.1072510868905363,2427,3.1072510868905363
Bulgaria,2020,18407,21,2020-05-25,6951482,86,1.2371462660767876,2513,1.2371462660767876
Bulgaria,2020,18414,22,2020-06-01,6951482,198,2.848313496316325,2711,2.848313496316325
Bulgaria,2020,18421,23,2020-06-08,6951482,555,7.983909042704851,3266,7.983909042704851
Bulgaria,2020,18428,24,2020-06-15,6951482,606,8.717565549331782,3872,8.717565549331782
Bulgaria,2020,18435,25,2020-06-22,6951482,753,10.832222539021176,4625,10.832222539021176
Bulgaria,2020,18442,26,2020-06-29,6951482,1052,15.133463626892798,5677,15.133463626892798
Bulgaria,2020,18449,27,2020-07-06,6951482,1498,21.549361704453812,7175,21.549361704453812
Bulgaria,2020,18456,28,2020-07-13,6951482,1463,21.045871945003956,8638,21.045871945003956
Bulgaria,2020,18463,29,2020-07-20,6951482,1674,24.08119592340166,10312,24.08119592340166
Bulgaria,2020,18470,30,2020-07-27,6951482,1524,21.92338266861656,11836,21.92338266861656
Bulgaria,2020,18477,31,2020-08-03,6951482,1507,21.67883049974092,13343,21.67883049974092
Bulgaria,2020,18484,32,2020-08-10,6951482,990,14.241567481581626,14333,14.241567481581626
Bulgaria,2020,18491,33,2020-08-17,6951482,894,12.860566998519165,15227,12.860566998519165
Bulgaria,2020,18498,34,2020-08-24,6951482,937,13.479140131557559,16164,13.479140131557559
Bulgaria,2020,18505,35,2020-08-31,6951482,886,12.745483624930626,17050,12.745483624930626
Bulgaria,2020,18512,36,2020-09-07,6951482,841,12.098139648495097,17891,12.098139648495097
Bulgaria,2020,18519,37,2020-09-14,6951482,928,13.349671336270452,18819,13.349671336270452
Bulgaria,2020,18526,38,2020-09-21,6951482,1178,16.94602676091228,19997,16.94602676091228
Bulgaria,2020,18533,39,2020-09-28,6951482,1521,21.88022640352086,21518,21.88022640352086
Bulgaria,2020,18540,40,2020-10-05,6951482,2801,40.293566177687005,24319,40.293566177687005
Bulgaria,2020,18547,41,2020-10-12,6951482,4789,68.8917845144388,29108,68.8917845144388
Bulgaria,2020,18554,42,2020-10-19,6951482,8454,121.61435503968794,37562,121.61435503968794
Bulgaria,2020,18561,43,2020-10-26,6951482,15282,219.83801439750545,52844,219.83801439750545
Bulgaria,2020,18568,44,2020-11-02,6951482,21641,311.3149109786949,74485,311.3149109786949
Bulgaria,2020,18575,45,2020-11-09,6951482,22950,330.1454279821195,97435,330.1454279821195
Bulgaria,2020,18582,46,2020-11-16,6951482,23262,334.63367955207246,120697,334.63367955207246
Bulgaria,2020,18589,47,2020-11-23,6951482,21050,302.8131267548416,141747,302.8131267548416
Bulgaria,2020,18596,48,2020-11-30,6951482,19097,274.7183981775397,160844,274.7183981775397
Bulgaria,2020,18603,49,2020-12-07,6951482,18108,260.4912161176566,178952,260.4912161176566
Bulgaria,2020,18610,50,2020-12-14,6951482,12077,173.73273785359726,191029,173.73273785359726
Bulgaria,2020,18617,51,2020-12-21,6951482,6355,91.41935489439518,197384,91.41935489439518
Bulgaria,2020,18624,52,2020-12-28,6951482,5496,79.06227765532587,202880,79.06227765532587
Bulgaria,2021,18631,0,2021-01-04,6951482,5526,79.49384030628289,208406,79.49384030628289
Bulgaria,2021,18631,1,2021-01-04,6951482,3330,47.903454256229104,211736,47.903454256229104
Bulgaria,2021,18638,2,2021-01-11,6951482,2960,42.580848227759205,214696,42.580848227759205
Bulgaria,2021,18645,3,2021-01-18,6951482,3922,56.419623901780945,218618,56.419623901780945
Bulgaria,2021,18652,4,2021-01-25,6951482,4934,70.97767066073105,223552,70.97767066073105
Bulgaria,2021,18659,5,2021-02-01,6951482,5964,85.79465501025537,229516,85.79465501025537
Bulgaria,2021,18666,6,2021-02-08,6951482,6923,99.59027441918141,236439,99.59027441918141
Bulgaria,2021,18673,7,2021-02-15,6951482,10267,147.69512457919046,246706,147.69512457919046
Bulgaria,2021,18680,8,2021-02-22,6951482,13105,188.52095135972445,259811,188.52095135972445
Bulgaria,2021,18687,9,2021-03-01,6951482,18067,259.9014138280154,277878,259.9014138280154
Bulgaria,2021,18694,10,2021-03-08,6951482,24602,353.9101446281527,302480,353.9101446281527
Bulgaria,2021,18701,11,2021-03-15,6951482,25290,363.80731475676697,327770,363.80731475676697
Bulgaria,2021,18708,12,2021-03-22,6951482,24489,352.2845919762146,352259,352.2845919762146
Bulgaria,2021,18715,13,2021-03-29,6951482,19272,277.23584697478896,371531,277.23584697478896
Bulgaria,2021,18722,14,2021-04-05,6951482,14432,207.61040595372324,385963,207.61040595372324
Bulgaria,2021,18729,15,2021-04-12,6951482,11137,160.210441456944,397100,160.210441456944
Bulgaria,2021,18736,16,2021-04-19,6951482,7746,111.4294764771023,404846,111.4294764771023
Bulgaria,2021,18743,17,2021-04-26,6951482,5115,73.58143198817173,409961,73.58143198817173
Bulgaria,2021,18750,18,2021-05-03,6951482,4080,58.692520530154574,414041,58.692520530154574
Bulgaria,2021,18757,19,2021-05-10,6951482,2524,36.30880436718386,416565,36.30880436718386
Bulgaria,2021,18764,20,2021-05-17,6951482,1656,23.822258332827445,418221,23.822258332827445
Bulgaria,2021,18771,21,2021-05-24,6951482,1205,17.334433146773595,419426,17.334433146773595
Bulgaria,2021,18778,22,2021-05-31,6951482,868,12.486546034356415,420294,12.486546034356415
Bulgaria,2021,18785,23,2021-06-07,6951482,711,10.228034827681348,421005,10.228034827681348
Bulgaria,2021,18792,24,2021-06-14,6951482,510,7.336565066269322,421515,7.336565066269322
Bulgaria,2021,18799,25,2021-06-21,6951482,519,7.4660338615564275,422034,7.4660338615564275
Bulgaria,2021,18806,26,2021-06-28,6951482,412,5.926793739809727,422446,5.926793739809727
Bulgaria,2021,18813,27,2021-07-05,6951482,484,6.962544102106572,422930,6.962544102106572
Bulgaria,2021,18820,28,2021-07-12,6951482,699,10.055409767298542,423629,10.055409767298542
Bulgaria,2021,18827,29,2021-07-19,6951482,1425,20.4992259204584,425054,20.4992259204584
Bulgaria,2021,18834,30,2021-07-26,6951482,2819,40.55250376826121,427873,40.55250376826121
Bulgaria,2021,18841,31,2021-08-02,6951482,5089,73.20741102400898,432962,73.20741102400898
Bulgaria,2021,18848,32,2021-08-09,6951482,7949,114.34971708191145,440911,114.34971708191145
Bulgaria,2021,18855,33,2021-08-16,6951482,10237,147.26356192823343,451148,147.26356192823343
Bulgaria,2021,18862,34,2021-08-23,6951482,10397,149.5652294000042,461545,149.5652294000042
Bulgaria,2021,18869,35,2021-08-30,6951482,9290,133.6405675796902,470835,133.6405675796902
Bulgaria,2021,18876,36,2021-09-06,6951482,10893,156.70039856249358,481728,156.70039856249358
Bulgaria,2021,18883,37,2021-09-13,6951482,10637,153.01773060766035,492365,153.01773060766035
Bulgaria,2021,18890,38,2021-09-20,6951482,13116,188.67919099840867,505481,188.67919099840867
Bulgaria,2021,18897,39,2021-09-27,6951482,14760,212.32882427085332,520241,212.32882427085332
Bulgaria,2021,18904,40,2021-10-04,6951482,19378,278.7607016748371,539619,278.7607016748371
Bulgaria,2021,18911,41,2021-10-11,6951482,28454,409.32278901103393,568073,409.32278901103393
Bulgaria,2021,18918,42,2021-10-18,6951482,32962,474.17227002817526,601035,474.17227002817526
Bulgaria,2021,18925,43,2021-10-25,6951482,30471,438.33818457704416,631506,438.33818457704416
Croatia,2020,18267,0,2020-01-06,4058165,0,0,0,0
Croatia,2020,18267,1,2020-01-06,4058165,0,0,0,0
Croatia,2020,18274,2,2020-01-13,4058165,0,0,0,0
Croatia,2020,18281,3,2020-01-20,4058165,0,0,0,0
Croatia,2020,18288,4,2020-01-27,4058165,0,0,0,0
Croatia,2020,18295,5,2020-02-03,4058165,0,0,0,0
Croatia,2020,18302,6,2020-02-10,4058165,0,0,0,0
Croatia,2020,18309,7,2020-02-17,4058165,0,0,0,0
Croatia,2020,18316,8,2020-02-24,4058165,7,0.17249175427810354,7,0.17249175427810354
Croatia,2020,18323,9,2020-03-02,4058165,5,0.12320839591293109,12,0.12320839591293109
Croatia,2020,18330,10,2020-03-09,4058165,36,0.8871004505731038,48,0.8871004505731038
Croatia,2020,18337,11,2020-03-16,4058165,187,4.607994007143623,235,4.607994007143623
Croatia,2020,18344,12,2020-03-23,4058165,478,11.778722649276212,713,11.778722649276212
Croatia,2020,18351,13,2020-03-30,4058165,469,11.556947536632936,1182,11.556947536632936
Croatia,2020,18358,14,2020-04-06,4058165,418,10.30022189832104,1600,10.30022189832104
Croatia,2020,18365,15,2020-04-13,4058165,271,6.677895058480865,1871,6.677895058480865
Croatia,2020,18372,16,2020-04-20,4058165,159,3.918026990031209,2030,3.918026990031209
Croatia,2020,18379,17,2020-04-27,4058165,66,1.6263508260506905,2096,1.6263508260506905
Croatia,2020,18386,18,2020-05-04,4058165,91,2.2423928056153457,2187,2.2423928056153457
Croatia,2020,18393,19,2020-05-11,4058165,39,0.9610254881208625,2226,0.9610254881208625
Croatia,2020,18400,20,2020-05-18,4058165,18,0.4435502252865519,2244,0.4435502252865519
Croatia,2020,18407,21,2020-05-25,4058165,2,0.04928335836517243,2246,0.04928335836517243
Croatia,2020,18414,22,2020-06-01,4058165,1,0.024641679182586217,2247,0.024641679182586217
Croatia,2020,18421,23,2020-06-08,4058165,5,0.12320839591293109,2252,0.12320839591293109
Croatia,2020,18428,24,2020-06-15,4058165,65,1.6017091468681042,2317,1.6017091468681042
Croatia,2020,18435,25,2020-06-22,4058165,374,9.215988014287246,2691,9.215988014287246
Croatia,2020,18442,26,2020-06-29,4058165,460,11.335172423989661,3151,11.335172423989661
Croatia,2020,18449,27,2020-07-06,4058165,571,14.07039881325673,3722,14.07039881325673
Croatia,2020,18456,28,2020-07-13,4058165,632,15.573541243394489,4354,15.573541243394489
Croatia,2020,18463,29,2020-07-20,4058165,503,12.394764628840868,4857,12.394764628840868
Croatia,2020,18470,30,2020-07-27,4058165,403,9.930596710582247,5260,9.930596710582247
Croatia,2020,18477,31,2020-08-03,4058165,344,8.47673763880966,5604,8.47673763880966
Croatia,2020,18484,32,2020-08-10,4058165,967,23.82850376956087,6571,23.82850376956087
Croatia,2020,18491,33,2020-08-17,4058165,1604,39.525253408868295,8175,39.525253408868295
Croatia,2020,18498,34,2020-08-24,4058165,1948,48.001991047677954,10123,48.001991047677954
Croatia,2020,18505,35,2020-08-31,4058165,1841,45.365331375141224,11964,45.365331375141224
Croatia,2020,18512,36,2020-09-07,4058165,1569,38.662794637477774,13533,38.662794637477774
Croatia,2020,18519,37,2020-09-14,4058165,1389,34.227292384612255,14922,34.227292384612255
Croatia,2020,18526,38,2020-09-21,4058165,1275,31.418140957797426,16197,31.418140957797426
Croatia,2020,18533,39,2020-09-28,4058165,1462,36.02613496494105,17659,36.02613496494105
Croatia,2020,18540,40,2020-10-05,4058165,2781,68.52850980677228,20440,68.52850980677228
Croatia,2020,18547,41,2020-10-12,4058165,5140,126.65823099849317,25580,126.65823099849317
Croatia,2020,18554,42,2020-10-19,4058165,10800,266.13013517193116,36380,266.13013517193116
Croatia,2020,18561,43,2020-10-26,4058165,15115,372.4589808447907,51495,372.4589808447907
Croatia,2020,18568,44,2020-11-02,4058165,15752,388.1557304840981,67247,388.1557304840981
Croatia,2020,18575,45,2020-11-09,4058165,16959,417.89823725747965,84206,417.89823725747965
Croatia,2020,18582,46,2020-11-16,4058165,19512,480.80844421062227,103718,480.80844421062227
Croatia,2020,18589,47,2020-11-23,4058165,22894,564.1466032061289,126612,564.1466032061289
Croatia,2020,18596,48,2020-11-30,4058165,23741,585.0181054737794,150353,585.0181054737794
Croatia,2020,18603,49,2020-12-07,4058165,25533,629.1759945689739,175886,629.1759945689739
Croatia,2020,18610,50,2020-12-14,4058165,19842,488.9401983408757,195728,488.9401983408757
Croatia,2020,18617,51,2020-12-21,4058165,9518,234.5395024598556,205246,234.5395024598556
Croatia,2020,18624,52,2020-12-28,4058165,7712,190.03662985610492,212958,190.03662985610492
Croatia,2021,18631,0,2021-01-04,4058165,7265,179.02179926148887,220223,179.02179926148887
Croatia,2021,18631,1,2021-01-04,4058165,4905,120.8674363905854,225128,120.8674363905854
Croatia,2021,18638,2,2021-01-11,4058165,3926,96.74323247083349,229054,96.74323247083349
Croatia,2021,18645,3,2021-01-18,4058165,3466,85.40806004684383,232520,85.40806004684383
Croatia,2021,18652,4,2021-01-25,4058165,2953,72.7668786261771,235473,72.7668786261771
Croatia,2021,18659,5,2021-02-01,4058165,2252,55.49306151918417,237725,55.49306151918417
Croatia,2021,18666,6,2021-02-08,4058165,2292,56.478728686487614,240017,56.478728686487614
Croatia,2021,18673,7,2021-02-15,4058165,3047,75.08319646934021,243064,75.08319646934021
Croatia,2021,18680,8,2021-02-22,4058165,3544,87.33011102308556,246608,87.33011102308556
Croatia,2021,18687,9,2021-03-01,4058165,4566,112.51390714768867,251174,112.51390714768867
Croatia,2021,18694,10,2021-03-08,4058165,6615,163.00470779280784,257789,163.00470779280784
Croatia,2021,18701,11,2021-03-15,4058165,9733,239.83746348411165,267522,239.83746348411165
Croatia,2021,18708,12,2021-03-22,4058165,12642,311.520108226255,280164,311.520108226255
Croatia,2021,18715,13,2021-03-29,4058165,12774,314.7728098783563,292938,314.7728098783563
Croatia,2021,18722,14,2021-04-05,4058165,15262,376.0813076846309,308200,376.0813076846309
Croatia,2021,18729,15,2021-04-12,4058165,14836,365.5839523528491,323036,365.5839523528491
Croatia,2021,18736,16,2021-04-19,4058165,12486,307.6760062737715,335522,307.6760062737715
Croatia,2021,18743,17,2021-04-26,4058165,9225,227.31949045935787,344747,227.31949045935787
Croatia,2021,18750,18,2021-05-03,4058165,5759,141.91143041251402,350506,141.91143041251402
Croatia,2021,18757,19,2021-05-10,4058165,3554,87.57652781491142,354060,87.57652781491142
Croatia,2021,18764,20,2021-05-17,4058165,2121,52.26500154626537,356181,52.26500154626537
Croatia,2021,18771,21,2021-05-24,4058165,1427,35.163676193550536,357608,35.163676193550536
Croatia,2021,18778,22,2021-05-31,4058165,973,23.97635384465639,358581,23.97635384465639
Croatia,2021,18785,23,2021-06-07,4058165,603,14.85893254709949,359184,14.85893254709949
Croatia,2021,18792,24,2021-06-14,4058165,482,11.877289366006558,359666,11.877289366006558
Croatia,2021,18799,25,2021-06-21,4058165,580,14.292173925900007,360246,14.292173925900007
Croatia,2021,18806,26,2021-06-28,4058165,595,14.6617991136388,360841,14.6617991136388
Croatia,2021,18813,27,2021-07-05,4058165,772,19.02337632895656,361613,19.02337632895656
Croatia,2021,18820,28,2021-07-12,4058165,1035,25.504137953976734,362648,25.504137953976734
Croatia,2021,18827,29,2021-07-19,4058165,1139,28.0668725889657,363787,28.0668725889657
Croatia,2021,18834,30,2021-07-26,4058165,1302,32.083466295727256,365089,32.083466295727256
Croatia,2021,18841,31,2021-08-02,4058165,1979,48.76588310233812,367068,48.76588310233812
Croatia,2021,18848,32,2021-08-09,4058165,2770,68.25745133576382,369838,68.25745133576382
Croatia,2021,18855,33,2021-08-16,4058165,3492,86.04874370559108,373330,86.04874370559108
Croatia,2021,18862,34,2021-08-23,4058165,4692,115.61875872469453,378022,115.61875872469453
Croatia,2021,18869,35,2021-08-30,4058165,6060,149.3285758464725,384082,149.3285758464725
Croatia,2021,18876,36,2021-09-06,4058165,8166,201.22395220499905,392248,201.22395220499905
Croatia,2021,18883,37,2021-09-13,4058165,7860,193.68359837512767,400108,193.68359837512767
Croatia,2021,18890,38,2021-09-20,4058165,8810,217.09319359858458,408918,217.09319359858458
Croatia,2021,18897,39,2021-09-27,4058165,9110,224.48569735336045,418028,224.48569735336045
Croatia,2021,18904,40,2021-10-04,4058165,10205,251.46833605829235,428233,251.46833605829235
Croatia,2021,18911,41,2021-10-11,4058165,17772,437.93192243292225,446005,437.93192243292225
Croatia,2021,18918,42,2021-10-18,4058165,25469,627.5989271012884,471474,627.5989271012884
Croatia,2021,18925,43,2021-10-25,4058165,31095,766.2330141825184,502569,766.2330141825184
Cyprus,2020,18267,0,2020-01-06,888005,0,0,0,0
Cyprus,2020,18267,1,2020-01-06,888005,0,0,0,0
Cyprus,2020,18274,2,2020-01-13,888005,0,0,0,0
Cyprus,2020,18281,3,2020-01-20,888005,0,0,0,0
Cyprus,2020,18288,4,2020-01-27,888005,0,0,0,0
Cyprus,2020,18295,5,2020-02-03,888005,0,0,0,0
Cyprus,2020,18302,6,2020-02-10,888005,0,0,0,0
Cyprus,2020,18309,7,2020-02-17,888005,0,0,0,0
Cyprus,2020,18316,8,2020-02-24,888005,0,0,0,0
Cyprus,2020,18323,9,2020-03-02,888005,1,0.11261197853615688,1,0.11261197853615688
Cyprus,2020,18330,10,2020-03-09,888005,44,4.954927055590903,45,4.954927055590903
Cyprus,2020,18337,11,2020-03-16,888005,76,8.558510368747923,121,8.558510368747923
Cyprus,2020,18344,12,2020-03-23,888005,167,18.8062004155382,288,18.8062004155382
Cyprus,2020,18351,13,2020-03-30,888005,208,23.423291535520633,496,23.423291535520633
Cyprus,2020,18358,14,2020-04-06,888005,193,21.73411185747828,689,21.73411185747828
Cyprus,2020,18365,15,2020-04-13,888005,84,9.459406197037179,773,9.459406197037179
Cyprus,2020,18372,16,2020-04-20,888005,54,6.081046840952472,827,6.081046840952472
Cyprus,2020,18379,17,2020-04-27,888005,49,5.5179869482716875,876,5.5179869482716875
Cyprus,2020,18386,18,2020-05-04,888005,29,3.26574737754855,905,3.26574737754855
Cyprus,2020,18393,19,2020-05-11,888005,14,1.5765676995061966,919,1.5765676995061966
Cyprus,2020,18400,20,2020-05-18,888005,20,2.252239570723138,939,2.252239570723138
Cyprus,2020,18407,21,2020-05-25,888005,11,1.2387317638977258,950,1.2387317638977258
Cyprus,2020,18414,22,2020-06-01,888005,22,2.4774635277954515,972,2.4774635277954515
Cyprus,2020,18421,23,2020-06-08,888005,16,1.8017916565785101,988,1.8017916565785101
Cyprus,2020,18428,24,2020-06-15,888005,3,0.3378359356084707,991,0.3378359356084707
Cyprus,2020,18435,25,2020-06-22,888005,8,0.9008958282892551,999,0.9008958282892551
Cyprus,2020,18442,26,2020-06-29,888005,8,0.9008958282892551,1007,0.9008958282892551
Cyprus,2020,18449,27,2020-07-06,888005,18,2.027015613650824,1025,2.027015613650824
Cyprus,2020,18456,28,2020-07-13,888005,16,1.8017916565785101,1041,1.8017916565785101
Cyprus,2020,18463,29,2020-07-20,888005,23,2.5900755063316083,1064,2.5900755063316083
Cyprus,2020,18470,30,2020-07-27,888005,107,12.049481703368787,1171,12.049481703368787
Cyprus,2020,18477,31,2020-08-03,888005,83,9.346794218501023,1254,9.346794218501023
Cyprus,2020,18484,32,2020-08-10,888005,102,11.486421810688002,1356,11.486421810688002
Cyprus,2020,18491,33,2020-08-17,888005,79,8.896346304356394,1435,8.896346304356394
Cyprus,2020,18498,34,2020-08-24,888005,58,6.5314947550971,1493,6.5314947550971
Cyprus,2020,18505,35,2020-08-31,888005,22,2.4774635277954515,1515,2.4774635277954515
Cyprus,2020,18512,36,2020-09-07,888005,23,2.5900755063316083,1538,2.5900755063316083
Cyprus,2020,18519,37,2020-09-14,888005,79,8.896346304356394,1617,8.896346304356394
Cyprus,2020,18526,38,2020-09-21,888005,110,12.387317638977258,1727,12.387317638977258
Cyprus,2020,18533,39,2020-09-28,888005,135,15.202617102381181,1862,15.202617102381181
Cyprus,2020,18540,40,2020-10-05,888005,208,23.423291535520633,2070,23.423291535520633
Cyprus,2020,18547,41,2020-10-12,888005,657,73.98606989825508,2727,73.98606989825508
Cyprus,2020,18554,42,2020-10-19,888005,978,110.13451500836143,3705,110.13451500836143
Cyprus,2020,18561,43,2020-10-26,888005,1106,124.54884826098952,4811,124.54884826098952
Cyprus,2020,18568,44,2020-11-02,888005,1324,149.09825958187173,6135,149.09825958187173
Cyprus,2020,18575,45,2020-11-09,888005,1237,139.30101744922607,7372,139.30101744922607
Cyprus,2020,18582,46,2020-11-16,888005,1716,193.24215516804523,9088,193.24215516804523
Cyprus,2020,18589,47,2020-11-23,888005,1702,191.66558746853903,10790,191.66558746853903
Cyprus,2020,18596,48,2020-11-30,888005,2557,287.94882911695316,13347,287.94882911695316
Cyprus,2020,18603,49,2020-12-07,888005,2605,293.3542040866887,15952,293.3542040866887
Cyprus,2020,18610,50,2020-12-14,888005,2467,277.81375104869903,18419,277.81375104869903
Cyprus,2020,18617,51,2020-12-21,888005,2280,256.7553110624377,20699,256.7553110624377
Cyprus,2020,18624,52,2020-12-28,888005,3826,430.85342987933626,24525,430.85342987933626
Cyprus,2021,18631,0,2021-01-04,888005,3104,349.547581376231,27629,349.547581376231
Cyprus,2021,18631,1,2021-01-04,888005,1570,176.80080630176633,29199,176.80080630176633
Cyprus,2021,18638,2,2021-01-11,888005,942,106.0804837810598,30141,106.0804837810598
Cyprus,2021,18645,3,2021-01-18,888005,797,89.75174689331705,30938,89.75174689331705
Cyprus,2021,18652,4,2021-01-25,888005,810,91.21570261428708,31748,91.21570261428708
Cyprus,2021,18659,5,2021-02-01,888005,700,78.82838497530982,32448,78.82838497530982
Cyprus,2021,18666,6,2021-02-08,888005,704,79.27883288945445,33152,79.27883288945445
Cyprus,2021,18673,7,2021-02-15,888005,1347,151.68833508820333,34499,151.68833508820333
Cyprus,2021,18680,8,2021-02-22,888005,1912,215.31410296113197,36411,215.31410296113197
Cyprus,2021,18687,9,2021-03-01,888005,2683,302.13793841250896,39094,302.13793841250896
Cyprus,2021,18694,10,2021-03-08,888005,2540,286.0344254818385,41634,286.0344254818385
Cyprus,2021,18701,11,2021-03-15,888005,2298,258.78232667608853,43932,258.78232667608853
Cyprus,2021,18708,12,2021-03-22,888005,3093,348.3088496123333,47025,348.3088496123333
Cyprus,2021,18715,13,2021-03-29,888005,3757,423.08320336034143,50782,423.08320336034143
Cyprus,2021,18722,14,2021-04-05,888005,4789,539.2987652096554,55571,539.2987652096554
Cyprus,2021,18729,15,2021-04-12,888005,5870,661.032314007241,61441,661.032314007241
Cyprus,2021,18736,16,2021-04-19,888005,4037,454.61455735046536,65478,454.61455735046536
Cyprus,2021,18743,17,2021-04-26,888005,3137,353.26377666792416,68615,353.26377666792416
Cyprus,2021,18750,18,2021-05-03,888005,1540,173.4224469456816,70155,173.4224469456816
Cyprus,2021,18757,19,2021-05-10,888005,862,97.07152549816723,71017,97.07152549816723
Cyprus,2021,18764,20,2021-05-17,888005,518,58.333004881729266,71535,58.333004881729266
Cyprus,2021,18771,21,2021-05-24,888005,398,44.81956745739044,71933,44.81956745739044
Cyprus,2021,18778,22,2021-05-31,888005,422,47.52225494225821,72355,47.52225494225821
Cyprus,2021,18785,23,2021-06-07,888005,492,55.40509343978919,72847,55.40509343978919
Cyprus,2021,18792,24,2021-06-14,888005,1275,143.58027263360003,74122,143.58027263360003
Cyprus,2021,18799,25,2021-06-21,888005,3618,407.43013834381566,77740,407.43013834381566
Cyprus,2021,18806,26,2021-06-28,888005,6972,785.1307143540859,84712,785.1307143540859
Cyprus,2021,18813,27,2021-07-05,888005,8232,927.0218073096436,92944,927.0218073096436
Cyprus,2021,18820,28,2021-07-12,888005,7135,803.4864668554794,100079,803.4864668554794
Cyprus,2021,18827,29,2021-07-19,888005,4951,557.5419057325128,105030,557.5419057325128
Cyprus,2021,18834,30,2021-07-26,888005,3511,395.38065664044683,108541,395.38065664044683
Cyprus,2021,18841,31,2021-08-02,888005,2728,307.205477446636,111269,307.205477446636
Cyprus,2021,18848,32,2021-08-09,888005,2304,259.45799854730546,113573,259.45799854730546
Cyprus,2021,18855,33,2021-08-16,888005,1777,200.1114858587508,115350,200.1114858587508
Cyprus,2021,18862,34,2021-08-23,888005,1480,166.6657282335122,116830,166.6657282335122
Cyprus,2021,18869,35,2021-08-30,888005,1030,115.9903378922416,117860,115.9903378922416
Cyprus,2021,18876,36,2021-09-06,888005,860,96.84630154109493,118720,96.84630154109493
Cyprus,2021,18883,37,2021-09-13,888005,693,78.04010112555673,119413,78.04010112555673
Cyprus,2021,18890,38,2021-09-20,888005,632,71.17077043485115,120045,71.17077043485115
Cyprus,2021,18897,39,2021-09-27,888005,740,83.3328641167561,120785,83.3328641167561
Cyprus,2021,18904,40,2021-10-04,888005,894,100.67510881132426,121679,100.67510881132426
Cyprus,2021,18911,41,2021-10-11,888005,925,104.16608014594513,122604,104.16608014594513
Cyprus,2021,18918,42,2021-10-18,888005,1042,117.34168163467548,123646,117.34168163467548
Cyprus,2021,18925,43,2021-10-25,888005,1410,158.78288973598123,125056,158.78288973598123
Czech Rep.,2020,18267,0,2020-01-06,10693939,0,0,0,0
Czech Rep.,2020,18267,1,2020-01-06,10693939,0,0,0,0
Czech Rep.,2020,18274,2,2020-01-13,10693939,0,0,0,0
Czech Rep.,2020,18281,3,2020-01-20,10693939,0,0,0,0
Czech Rep.,2020,18288,4,2020-01-27,10693939,0,0,0,0
Czech Rep.,2020,18295,5,2020-02-03,10693939,0,0,0,0
Czech Rep.,2020,18302,6,2020-02-10,10693939,0,0,0,0
Czech Rep.,2020,18309,7,2020-02-17,10693939,0,0,0,0
Czech Rep.,2020,18316,8,2020-02-24,10693939,3,0.028053273915252367,3,0.028053273915252367
Czech Rep.,2020,18323,9,2020-03-02,10693939,30,0.2805327391525237,33,0.2805327391525237
Czech Rep.,2020,18330,10,2020-03-09,10693939,266,2.4873902871523765,299,2.4873902871523765
Czech Rep.,2020,18337,11,2020-03-16,10693939,866,8.09804507020285,1165,8.09804507020285
Czech Rep.,2020,18344,12,2020-03-23,10693939,1661,15.532162657744728,2826,15.532162657744728
Czech Rep.,2020,18351,13,2020-03-30,10693939,1772,16.570133792609067,4598,16.570133792609067
Czech Rep.,2020,18358,14,2020-04-06,10693939,1405,13.138283283643192,6003,13.138283283643192
Czech Rep.,2020,18365,15,2020-04-13,10693939,755,7.0600739353385125,6758,7.0600739353385125
Czech Rep.,2020,18372,16,2020-04-20,10693939,658,6.153018078745353,7416,6.153018078745353
Czech Rep.,2020,18379,17,2020-04-27,10693939,379,3.5440636046268827,7795,3.5440636046268827
Czech Rep.,2020,18386,18,2020-05-04,10693939,344,3.2167754089489384,8139,3.2167754089489384
Czech Rep.,2020,18393,19,2020-05-11,10693939,359,3.3570417785252,8498,3.3570417785252
Czech Rep.,2020,18400,20,2020-05-18,10693939,485,4.535279282965799,8983,4.535279282965799
Czech Rep.,2020,18407,21,2020-05-25,10693939,318,2.973647035016751,9301,2.973647035016751
Czech Rep.,2020,18414,22,2020-06-01,10693939,366,3.422499417660789,9667,3.422499417660789
Czech Rep.,2020,18421,23,2020-06-08,10693939,399,3.731085430728565,10066,3.731085430728565
Czech Rep.,2020,18428,24,2020-06-15,10693939,474,4.432417278609874,10540,4.432417278609874
Czech Rep.,2020,18435,25,2020-06-22,10693939,1106,10.34230698342304,11646,10.34230698342304
Czech Rep.,2020,18442,26,2020-06-29,10693939,909,8.500141996321467,12555,8.500141996321467
Czech Rep.,2020,18449,27,2020-07-06,10693939,656,6.134315896135185,13211,6.134315896135185
Czech Rep.,2020,18456,28,2020-07-13,10693939,770,7.200340304914775,13981,7.200340304914775
Czech Rep.,2020,18463,29,2020-07-20,10693939,1375,12.857750544490669,15356,12.857750544490669
Czech Rep.,2020,18470,30,2020-07-27,10693939,1454,13.596486757592315,16810,13.596486757592315
Czech Rep.,2020,18477,31,2020-08-03,10693939,1567,14.65316007506682,18377,14.65316007506682
Czech Rep.,2020,18484,32,2020-08-10,10693939,1657,15.494758292524391,20034,15.494758292524391
Czech Rep.,2020,18491,33,2020-08-17,10693939,1905,17.813828936185253,21939,17.813828936185253
Czech Rep.,2020,18498,34,2020-08-24,10693939,2448,22.891471514845932,24387,22.891471514845932
Czech Rep.,2020,18505,35,2020-08-31,10693939,3786,35.40323168104849,28173,35.40323168104849
Czech Rep.,2020,18512,36,2020-09-07,10693939,8033,75.11731645374076,36206,75.11731645374076
Czech Rep.,2020,18519,37,2020-09-14,10693939,13098,122.48059391399184,49304,122.48059391399184
Czech Rep.,2020,18526,38,2020-09-21,10693939,15306,143.1278035156176,64610,143.1278035156176
Czech Rep.,2020,18533,39,2020-09-28,10693939,17865,167.05724616532785,82475,167.05724616532785
Czech Rep.,2020,18540,40,2020-10-05,10693939,34664,324.14622899943606,117139,324.14622899943606
Czech Rep.,2020,18547,41,2020-10-12,10693939,56777,530.9269110287612,173916,530.9269110287612
Czech Rep.,2020,18554,42,2020-10-19,10693939,84209,787.4460477098289,258125,787.4460477098289
Czech Rep.,2020,18561,43,2020-10-26,10693939,83547,781.2556252658632,341672,781.2556252658632
Czech Rep.,2020,18568,44,2020-11-02,10693939,73164,684.1632442451747,414836,684.1632442451747
Czech Rep.,2020,18575,45,2020-11-09,10693939,45344,424.0158841377345,460180,424.0158841377345
Czech Rep.,2020,18582,46,2020-11-16,10693939,32152,300.6562876410647,492332,300.6562876410647
Czech Rep.,2020,18589,47,2020-11-23,10693939,27421,256.41627467671174,519753,256.41627467671174
Czech Rep.,2020,18596,48,2020-11-30,10693939,27108,253.4893830982204,546861,253.4893830982204
Czech Rep.,2020,18603,49,2020-12-07,10693939,34254,320.31228156435157,581115,320.31228156435157
Czech Rep.,2020,18610,50,2020-12-14,10693939,46520,435.0127675125134,627635,435.0127675125134
Czech Rep.,2020,18617,51,2020-12-21,10693939,46855,438.1453830997166,674490,438.1453830997166
Czech Rep.,2020,18624,52,2020-12-28,10693939,72471,677.6829379707515,746961,677.6829379707515
Czech Rep.,2021,18631,0,2021-01-04,10693939,88923,831.5270921219955,835884,831.5270921219955
Czech Rep.,2021,18631,1,2021-01-04,10693939,56473,528.0841792720157,892357,528.0841792720157
Czech Rep.,2021,18638,2,2021-01-11,10693939,48185,450.5823345354785,940542,450.5823345354785
Czech Rep.,2021,18645,3,2021-01-18,10693939,47396,443.2043234957671,987938,443.2043234957671
Czech Rep.,2021,18652,4,2021-01-25,10693939,50088,468.37746128905354,1038026,468.37746128905354
Czech Rep.,2021,18659,5,2021-02-01,10693939,53524,500.50781101332257,1091550,500.50781101332257
Czech Rep.,2021,18666,6,2021-02-08,10693939,66328,620.2391840836196,1157878,620.2391840836196
Czech Rep.,2021,18673,7,2021-02-15,10693939,82954,775.7104281219483,1240832,775.7104281219483
Czech Rep.,2021,18680,8,2021-02-22,10693939,85355,798.1623983454554,1326187,798.1623983454554
Czech Rep.,2021,18687,9,2021-03-01,10693939,77196,721.866844387274,1403383,721.866844387274
Czech Rep.,2021,18694,10,2021-03-08,10693939,65006,607.8770413782985,1468389,607.8770413782985
Czech Rep.,2021,18701,11,2021-03-15,10693939,49468,462.57978467990137,1517857,462.57978467990137
Czech Rep.,2021,18708,12,2021-03-22,10693939,37036,346.32701757509557,1554893,346.32701757509557
Czech Rep.,2021,18715,13,2021-03-29,10693939,27394,256.16379521147445,1582287,256.16379521147445
Czech Rep.,2021,18722,14,2021-04-05,10693939,21529,201.31964470715607,1603816,201.31964470715607
Czech Rep.,2021,18729,15,2021-04-12,10693939,17487,163.52253365200605,1621303,163.52253365200605
Czech Rep.,2021,18736,16,2021-04-19,10693939,14407,134.72117243234695,1635710,134.72117243234695
Czech Rep.,2021,18743,17,2021-04-26,10693939,10844,101.40323411233223,1646554,101.40323411233223
Czech Rep.,2021,18750,18,2021-05-03,10693939,7637,71.41428429692745,1654191,71.41428429692745
Czech Rep.,2021,18757,19,2021-05-10,10693939,5001,46.7648076167257,1659192,46.7648076167257
Czech Rep.,2021,18764,20,2021-05-17,10693939,3199,29.914141084964108,1662391,29.914141084964108
Czech Rep.,2021,18771,21,2021-05-24,10693939,2352,21.993766749557857,1664743,21.993766749557857
Czech Rep.,2021,18778,22,2021-05-31,10693939,1417,13.250496379304202,1666160,13.250496379304202
Czech Rep.,2021,18785,23,2021-06-07,10693939,935,8.743270370253654,1667095,8.743270370253654
Czech Rep.,2021,18792,24,2021-06-14,10693939,694,6.489657365728381,1667789,6.489657365728381
Czech Rep.,2021,18799,25,2021-06-21,10693939,1011,9.453953309440049,1668800,9.453953309440049
Czech Rep.,2021,18806,26,2021-06-28,10693939,1361,12.726835266219492,1670161,12.726835266219492
Czech Rep.,2021,18813,27,2021-07-05,10693939,1610,15.055257001185439,1671771,15.055257001185439
Czech Rep.,2021,18820,28,2021-07-12,10693939,1344,12.56786671403306,1673115,12.56786671403306
Czech Rep.,2021,18827,29,2021-07-19,10693939,1180,11.034287739999264,1674295,11.034287739999264
Czech Rep.,2021,18834,30,2021-07-26,10693939,1196,11.183905200880611,1675491,11.183905200880611
Czech Rep.,2021,18841,31,2021-08-02,10693939,1279,11.960045779202593,1676770,11.960045779202593
Czech Rep.,2021,18848,32,2021-08-09,10693939,1300,12.156418696609359,1678070,12.156418696609359
Czech Rep.,2021,18855,33,2021-08-16,10693939,1313,12.277982883575453,1679383,12.277982883575453
Czech Rep.,2021,18862,34,2021-08-23,10693939,1754,16.401814149117552,1681137,16.401814149117552
Czech Rep.,2021,18869,35,2021-08-30,10693939,2605,24.35959284974414,1683742,24.35959284974414
Czech Rep.,2021,18876,36,2021-09-06,10693939,3058,28.59563721094725,1686800,28.59563721094725
Czech Rep.,2021,18883,37,2021-09-13,10693939,3255,30.43780219804882,1690055,30.43780219804882
Czech Rep.,2021,18890,38,2021-09-20,10693939,4495,42.03315541635313,1694550,42.03315541635313
Czech Rep.,2021,18897,39,2021-09-27,10693939,5971,55.835366182657296,1700521,55.835366182657296
Czech Rep.,2021,18904,40,2021-10-04,10693939,9626,90.01360490273977,1710147,90.01360490273977
Czech Rep.,2021,18911,41,2021-10-11,10693939,21533,201.3570490723764,1731680,201.3570490723764
Czech Rep.,2021,18918,42,2021-10-18,10693939,34352,321.2286885122498,1766032,321.2286885122498
Czech Rep.,2021,18925,43,2021-10-25,10693939,53421,499.5446486088989,1819453,499.5446486088989
Denmark,2020,18267,0,2020-01-06,5822763,0,0,0,0
Denmark,2020,18267,1,2020-01-06,5822763,0,0,0,0
Denmark,2020,18274,2,2020-01-13,5822763,0,0,0,0
Denmark,2020,18281,3,2020-01-20,5822763,0,0,0,0
Denmark,2020,18288,4,2020-01-27,5822763,0,0,0,0
Denmark,2020,18295,5,2020-02-03,5822763,0,0,0,0
Denmark,2020,18302,6,2020-02-10,5822763,0,0,0,0
Denmark,2020,18309,7,2020-02-17,5822763,0,0,0,0
Denmark,2020,18316,8,2020-02-24,5822763,4,0.06869590948489575,4,0.06869590948489575
Denmark,2020,18323,9,2020-03-02,5822763,81,1.3910921670691387,85,1.3910921670691387
Denmark,2020,18330,10,2020-03-09,5822763,833,14.305923150229539,918,14.305923150229539
Denmark,2020,18337,11,2020-03-16,5822763,556,9.548731418400509,1474,9.548731418400509
Denmark,2020,18344,12,2020-03-23,5822763,1137,19.526812271081614,2611,19.526812271081614
Denmark,2020,18351,13,2020-03-30,5822763,2175,37.35340078241206,4786,37.35340078241206
Denmark,2020,18358,14,2020-04-06,5822763,1662,28.543150390974183,6448,28.543150390974183
Denmark,2020,18365,15,2020-04-13,5822763,1185,20.351163184900365,7633,20.351163184900365
Denmark,2020,18372,16,2020-04-20,5822763,1308,22.463562401560907,8941,22.463562401560907
Denmark,2020,18379,17,2020-04-27,5822763,1004,17.242673280708832,9945,17.242673280708832
Denmark,2020,18386,18,2020-05-04,5822763,675,11.592434725576156,10620,11.592434725576156
Denmark,2020,18393,19,2020-05-11,5822763,448,7.693941862308323,11068,7.693941862308323
Denmark,2020,18400,20,2020-05-18,5822763,395,6.783721061633455,11463,6.783721061633455
Denmark,2020,18407,21,2020-05-25,5822763,309,5.306759007708196,11772,5.306759007708196
Denmark,2020,18414,22,2020-06-01,5822763,252,4.327842297548432,12024,4.327842297548432
Denmark,2020,18421,23,2020-06-08,5822763,271,4.6541478676016865,12295,4.6541478676016865
Denmark,2020,18428,24,2020-06-15,5822763,324,5.564368668276555,12619,5.564368668276555
Denmark,2020,18435,25,2020-06-22,5822763,196,3.3660995647598915,12815,3.3660995647598915
Denmark,2020,18442,26,2020-06-29,5822763,124,2.129573194031768,12939,2.129573194031768
Denmark,2020,18449,27,2020-07-06,5822763,170,2.919576153108069,13109,2.919576153108069
Denmark,2020,18456,28,2020-07-13,5822763,264,4.5339300260031195,13373,4.5339300260031195
Denmark,2020,18463,29,2020-07-20,5822763,248,4.259146388063536,13621,4.259146388063536
Denmark,2020,18470,30,2020-07-27,5822763,494,8.483944821384624,14115,8.483944821384624
Denmark,2020,18477,31,2020-08-03,5822763,896,15.387883724616646,15011,15.387883724616646
Denmark,2020,18484,32,2020-08-10,5822763,893,15.336361792502975,15904,15.336361792502975
Denmark,2020,18491,33,2020-08-17,5822763,621,10.665039947530063,16525,10.665039947530063
Denmark,2020,18498,34,2020-08-24,5822763,592,10.16699460376457,17117,10.16699460376457
Denmark,2020,18505,35,2020-08-31,5822763,1193,20.488555003870157,18310,20.488555003870157
Denmark,2020,18512,36,2020-09-07,5822763,2237,38.41818737942795,20547,38.41818737942795
Denmark,2020,18519,37,2020-09-14,5822763,3208,55.094119406886385,23755,55.094119406886385
Denmark,2020,18526,38,2020-09-21,5822763,3631,62.35871183491411,27386,62.35871183491411
Denmark,2020,18533,39,2020-09-28,5822763,2828,48.56800800582129,30214,48.56800800582129
Denmark,2020,18540,40,2020-10-05,5822763,2704,46.43843481178952,32918,46.43843481178952
Denmark,2020,18547,41,2020-10-12,5822763,3212,55.16281531637128,36130,55.16281531637128
Denmark,2020,18554,42,2020-10-19,5822763,5858,100.60515944062982,41988,100.60515944062982
Denmark,2020,18561,43,2020-10-26,5822763,7565,129.92113881330908,49553,129.92113881330908
Denmark,2020,18568,44,2020-11-02,5822763,7423,127.48243402659527,56976,127.48243402659527
Denmark,2020,18575,45,2020-11-09,5822763,7542,129.52613733377092,64518,129.52613733377092
Denmark,2020,18582,46,2020-11-16,5822763,7197,123.60111514069867,71715,123.60111514069867
Denmark,2020,18589,47,2020-11-23,5822763,8793,151.01078302517206,80508,151.01078302517206
Denmark,2020,18596,48,2020-11-30,5822763,12833,220.39365160491678,93341,220.39365160491678
Denmark,2020,18603,49,2020-12-07,5822763,21991,377.6729363705856,115332,377.6729363705856
Denmark,2020,18610,50,2020-12-14,5822763,24713,424.4205027750571,140045,424.4205027750571
Denmark,2020,18617,51,2020-12-21,5822763,17147,294.4821899843768,157192,294.4821899843768
Denmark,2020,18624,52,2020-12-28,5822763,14594,250.63702575564213,171786,250.63702575564213
Denmark,2021,18631,0,2021-01-04,5822763,11359,195.07920895973268,183145,195.07920895973268
Denmark,2021,18631,1,2021-01-04,5822763,7154,122.86263411373604,190299,122.86263411373604
Denmark,2021,18638,2,2021-01-11,5822763,5401,92.75665178198048,195700,92.75665178198048
Denmark,2021,18645,3,2021-01-18,5822763,3249,55.798252479106566,198949,55.798252479106566
Denmark,2021,18652,4,2021-01-25,5822763,3124,53.65150530770357,202073,53.65150530770357
Denmark,2021,18659,5,2021-02-01,5822763,2770,47.5719173182903,204843,47.5719173182903
Denmark,2021,18666,6,2021-02-08,5822763,3586,61.585882853209036,208429,61.585882853209036
Denmark,2021,18673,7,2021-02-15,5822763,3942,67.69981879736476,212371,67.69981879736476
Denmark,2021,18680,8,2021-02-22,5822763,4226,72.57722837079235,216597,72.57722837079235
Denmark,2021,18687,9,2021-03-01,5822763,4655,79.94486466304743,221252,79.94486466304743
Denmark,2021,18694,10,2021-03-08,5822763,5172,88.8238109639702,226424,88.8238109639702
Denmark,2021,18701,11,2021-03-15,5822763,5113,87.81054629906798,231537,87.81054629906798
Denmark,2021,18708,12,2021-03-22,5822763,4399,75.5483264560141,235936,75.5483264560141
Denmark,2021,18715,13,2021-03-29,5822763,2567,44.085599911931844,238503,44.085599911931844
Denmark,2021,18722,14,2021-04-05,5822763,5050,86.72858572468088,243553,86.72858572468088
Denmark,2021,18729,15,2021-04-12,5822763,4850,83.29379025043609,248403,83.29379025043609
Denmark,2021,18736,16,2021-04-19,5822763,3239,55.626512705394326,251642,55.626512705394326
Denmark,2021,18743,17,2021-04-26,5822763,6492,111.4934610939858,258134,111.4934610939858
Denmark,2021,18750,18,2021-05-03,5822763,7225,124.08198650709294,265359,124.08198650709294
Denmark,2021,18757,19,2021-05-10,5822763,6873,118.03674647242211,272232,118.03674647242211
Denmark,2021,18764,20,2021-05-17,5822763,6698,115.03130043245793,278930,115.03130043245793
Denmark,2021,18771,21,2021-05-24,5822763,5660,97.20471192112748,284590,97.20471192112748
Denmark,2021,18778,22,2021-05-31,5822763,2810,48.25887641313926,287400,48.25887641313926
Denmark,2021,18785,23,2021-06-07,5822763,1652,28.371410617261944,289052,28.371410617261944
Denmark,2021,18792,24,2021-06-14,5822763,1313,22.549432288417027,290365,22.549432288417027
Denmark,2021,18799,25,2021-06-21,5822763,2672,45.88886753591036,293037,45.88886753591036
Denmark,2021,18806,26,2021-06-28,5822763,4611,79.18920965871357,297648,79.18920965871357
Denmark,2021,18813,27,2021-07-05,5822763,6815,117.04065578489113,304463,117.04065578489113
Denmark,2021,18820,28,2021-07-12,5822763,5287,90.79881836166095,309750,90.79881836166095
Denmark,2021,18827,29,2021-07-19,5822763,6250,107.3373585701496,316000,107.3373585701496
Denmark,2021,18834,30,2021-07-26,5822763,6349,109.03758232990077,322349,109.03758232990077
Denmark,2021,18841,31,2021-08-02,5822763,6857,117.76196283448253,329206,117.76196283448253
Denmark,2021,18848,32,2021-08-09,5822763,5663,97.25623385324116,334869,97.25623385324116
Denmark,2021,18855,33,2021-08-16,5822763,5277,90.62707858794872,340146,90.62707858794872
Denmark,2021,18862,34,2021-08-23,5822763,2924,50.216709833458786,343070,50.216709833458786
Denmark,2021,18869,35,2021-08-30,5822763,3211,55.14564133900006,346281,55.14564133900006
Denmark,2021,18876,36,2021-09-06,5822763,2173,37.319052827669616,348454,37.319052827669616
Denmark,2021,18883,37,2021-09-13,5822763,2524,43.34711888496921,350978,43.34711888496921
Denmark,2021,18890,38,2021-09-20,5822763,3012,51.72801984212649,353990,51.72801984212649
Denmark,2021,18897,39,2021-09-27,5822763,4059,69.70917414979796,358049,69.70917414979796
Denmark,2021,18904,40,2021-10-04,5822763,5013,86.0931485619456,363062,86.0931485619456
Denmark,2021,18911,41,2021-10-11,5822763,8669,148.8812098311403,371731,148.8812098311403
Denmark,2021,18918,42,2021-10-18,5822763,11875,203.94098128328423,383606,203.94098128328423
Denmark,2021,18925,43,2021-10-25,5822763,15971,274.2855925958175,399577,274.2855925958175
Estonia,2020,18267,0,2020-01-06,1328976,0,0,0,0
Estonia,2020,18267,1,2020-01-06,1328976,0,0,0,0
Estonia,2020,18274,2,2020-01-13,1328976,0,0,0,0
Estonia,2020,18281,3,2020-01-20,1328976,0,0,0,0
Estonia,2020,18288,4,2020-01-27,1328976,0,0,0,0
Estonia,2020,18295,5,2020-02-03,1328976,0,0,0,0
Estonia,2020,18302,6,2020-02-10,1328976,0,0,0,0
Estonia,2020,18309,7,2020-02-17,1328976,0,0,0,0
Estonia,2020,18316,8,2020-02-24,1328976,1,0.07524590361300731,1,0.07524590361300731
Estonia,2020,18323,9,2020-03-02,1328976,9,0.6772131325170657,10,0.6772131325170657
Estonia,2020,18330,10,2020-03-09,1328976,161,12.114590481694176,171,12.114590481694176
Estonia,2020,18337,11,2020-03-16,1328976,155,11.663115060016132,326,11.663115060016132
Estonia,2020,18344,12,2020-03-23,1328976,353,26.56180397539158,679,26.56180397539158
Estonia,2020,18351,13,2020-03-30,1328976,418,31.452787710237054,1097,31.452787710237054
Estonia,2020,18358,14,2020-04-06,1328976,212,15.952131565957549,1309,15.952131565957549
Estonia,2020,18365,15,2020-04-13,1328976,219,16.4788528912486,1528,16.4788528912486
Estonia,2020,18372,16,2020-04-20,1328976,115,8.653278915495841,1643,8.653278915495841
Estonia,2020,18379,17,2020-04-27,1328976,57,4.289016505941417,1700,4.289016505941417
Estonia,2020,18386,18,2020-05-04,1328976,39,2.934590240907285,1739,2.934590240907285
Estonia,2020,18393,19,2020-05-11,1328976,35,2.6336066264552556,1774,2.6336066264552556
Estonia,2020,18400,20,2020-05-18,1328976,49,3.687049277037358,1823,3.687049277037358
Estonia,2020,18407,21,2020-05-25,1328976,46,3.461311566198336,1869,3.461311566198336
Estonia,2020,18414,22,2020-06-01,1328976,70,5.267213252910511,1939,5.267213252910511
Estonia,2020,18421,23,2020-06-08,1328976,34,2.5583607228422482,1973,2.5583607228422482
Estonia,2020,18428,24,2020-06-15,1328976,8,0.6019672289040585,1981,0.6019672289040585
Estonia,2020,18435,25,2020-06-22,1328976,6,0.45147542167804383,1987,0.45147542167804383
Estonia,2020,18442,26,2020-06-29,1328976,6,0.45147542167804383,1993,0.45147542167804383
Estonia,2020,18449,27,2020-07-06,1328976,21,1.5801639758731534,2014,1.5801639758731534
Estonia,2020,18456,28,2020-07-13,1328976,7,0.5267213252910512,2021,0.5267213252910512
Estonia,2020,18463,29,2020-07-20,1328976,13,0.978196746969095,2034,0.978196746969095
Estonia,2020,18470,30,2020-07-27,1328976,45,3.3860656625853287,2079,3.3860656625853287
Estonia,2020,18477,31,2020-08-03,1328976,73,5.492950963749533,2152,5.492950963749533
Estonia,2020,18484,32,2020-08-10,1328976,38,2.8593443372942775,2190,2.8593443372942775
Estonia,2020,18491,33,2020-08-17,1328976,82,6.170164096266599,2272,6.170164096266599
Estonia,2020,18498,34,2020-08-24,1328976,101,7.599836264913738,2373,7.599836264913738
Estonia,2020,18505,35,2020-08-31,1328976,142,10.684918313047037,2515,10.684918313047037
Estonia,2020,18512,36,2020-09-07,1328976,161,12.114590481694176,2676,12.114590481694176
Estonia,2020,18519,37,2020-09-14,1328976,248,18.660984096025814,2924,18.660984096025814
Estonia,2020,18526,38,2020-09-21,1328976,276,20.767869397190015,3200,20.767869397190015
Estonia,2020,18533,39,2020-09-28,1328976,407,30.625082770493975,3607,30.625082770493975
Estonia,2020,18540,40,2020-10-05,1328976,258,19.413443132155887,3865,19.413443132155887
Estonia,2020,18547,41,2020-10-12,1328976,213,16.027377469570556,4078,16.027377469570556
Estonia,2020,18554,42,2020-10-19,1328976,333,25.056885903131434,4411,25.056885903131434
Estonia,2020,18561,43,2020-10-26,1328976,574,43.191148673866195,4985,43.191148673866195
Estonia,2020,18568,44,2020-11-02,1328976,1140,85.78033011882833,6125,85.78033011882833
Estonia,2020,18575,45,2020-11-09,1328976,1512,113.77180626286705,7637,113.77180626286705
Estonia,2020,18582,46,2020-11-16,1328976,2087,157.03820084034626,9724,157.03820084034626
Estonia,2020,18589,47,2020-11-23,1328976,2328,175.172463611081,12052,175.172463611081
Estonia,2020,18596,48,2020-11-30,1328976,2926,220.16951397165937,14978,220.16951397165937
Estonia,2020,18603,49,2020-12-07,1328976,3077,231.53164541722347,18055,231.53164541722347
Estonia,2020,18610,50,2020-12-14,1328976,3739,281.3444336090343,21794,281.3444336090343
Estonia,2020,18617,51,2020-12-21,1328976,4014,302.03705710261136,25808,302.03705710261136
Estonia,2020,18624,52,2020-12-28,1328976,3713,279.38804011509615,29521,279.38804011509615
Estonia,2021,18631,0,2021-01-04,1328976,4284,322.3534510781233,33805,322.3534510781233
Estonia,2021,18631,1,2021-01-04,1328976,3539,266.2952528864329,37344,266.2952528864329
Estonia,2021,18638,2,2021-01-11,1328976,3372,253.72918698306063,40716,253.72918698306063
Estonia,2021,18645,3,2021-01-18,1328976,3492,262.7586954166215,44208,262.7586954166215
Estonia,2021,18652,4,2021-01-25,1328976,4059,305.42312276519664,48267,305.42312276519664
Estonia,2021,18659,5,2021-02-01,1328976,4560,343.1213204753133,52827,343.1213204753133
Estonia,2021,18666,6,2021-02-08,1328976,4789,360.352632402692,57616,360.352632402692
Estonia,2021,18673,7,2021-02-15,1328976,9012,678.1160833604218,66628,678.1160833604218
Estonia,2021,18680,8,2021-02-22,1328976,9555,718.9746090222849,76183,718.9746090222849
Estonia,2021,18687,9,2021-03-01,1328976,9903,745.1601834796114,86086,745.1601834796114
Estonia,2021,18694,10,2021-03-08,1328976,10308,775.6347744428793,96394,775.6347744428793
Estonia,2021,18701,11,2021-03-15,1328976,7820,588.4229662537172,104214,588.4229662537172
Estonia,2021,18708,12,2021-03-22,1328976,5567,418.8939454136117,109781,418.8939454136117
Estonia,2021,18715,13,2021-03-29,1328976,4662,350.79640264384005,114443,350.79640264384005
Estonia,2021,18722,14,2021-04-05,1328976,3339,251.2460721638314,117782,251.2460721638314
Estonia,2021,18729,15,2021-04-12,1328976,2596,195.33836577936697,120378,195.33836577936697
Estonia,2021,18736,16,2021-04-19,1328976,2565,193.00574276736376,122943,193.00574276736376
Estonia,2021,18743,17,2021-04-26,1328976,2394,180.1386932495395,125337,180.1386932495395
Estonia,2021,18750,18,2021-05-03,1328976,1869,140.63459385271065,127206,140.63459385271065
Estonia,2021,18757,19,2021-05-10,1328976,1463,110.08475698582969,128669,110.08475698582969
Estonia,2021,18764,20,2021-05-17,1328976,875,65.84016566138139,129544,65.84016566138139
Estonia,2021,18771,21,2021-05-24,1328976,612,46.05049301116047,130156,46.05049301116047
Estonia,2021,18778,22,2021-05-31,1328976,382,28.74393518016879,130538,28.74393518016879
Estonia,2021,18785,23,2021-06-07,1328976,280,21.068853011642044,130818,21.068853011642044
Estonia,2021,18792,24,2021-06-14,1328976,165,12.415574096146205,130983,12.415574096146205
Estonia,2021,18799,25,2021-06-21,1328976,224,16.85508240931364,131207,16.85508240931364
Estonia,2021,18806,26,2021-06-28,1328976,301,22.6490169875152,131508,22.6490169875152
Estonia,2021,18813,27,2021-07-05,1328976,374,28.141967951264732,131882,28.141967951264732
Estonia,2021,18820,28,2021-07-12,1328976,642,48.30787011955069,132524,48.30787011955069
Estonia,2021,18827,29,2021-07-19,1328976,1247,93.83164180542012,133771,93.83164180542012
Estonia,2021,18834,30,2021-07-26,1328976,1452,109.25705204608661,135223,109.25705204608661
Estonia,2021,18841,31,2021-08-02,1328976,1932,145.37508578033012,137155,145.37508578033012
Estonia,2021,18848,32,2021-08-09,1328976,1971,148.3096760212374,139126,148.3096760212374
Estonia,2021,18855,33,2021-08-16,1328976,2473,186.08311963496706,141599,186.08311963496706
Estonia,2021,18862,34,2021-08-23,1328976,2402,180.74066047844354,144001,180.74066047844354
Estonia,2021,18869,35,2021-08-30,1328976,2883,216.93394011630008,146884,216.93394011630008
Estonia,2021,18876,36,2021-09-06,1328976,3258,245.15115397117782,150142,245.15115397117782
Estonia,2021,18883,37,2021-09-13,1328976,3784,284.73049927161964,153926,284.73049927161964
Estonia,2021,18890,38,2021-09-20,1328976,4969,373.8968950530333,158895,373.8968950530333
Estonia,2021,18897,39,2021-09-27,1328976,6450,485.3360783038971,165345,485.3360783038971
Estonia,2021,18904,40,2021-10-04,1328976,7990,601.2147698679283,173335,601.2147698679283
Estonia,2021,18911,41,2021-10-11,1328976,9985,751.330347575878,183320,751.330347575878
Estonia,2021,18918,42,2021-10-18,1328976,12062,907.6160893800942,195382,907.6160893800942
Estonia,2021,18925,43,2021-10-25,1328976,10501,790.1572338401897,205883,790.1572338401897
Faroe Islands,2020,18323,9,2020-03-02,48865,3,6.139363552645042,3,6.139363552645042
Faroe Islands,2020,18330,10,2020-03-09,48865,6,12.278727105290084,9,12.278727105290084
Faroe Islands,2020,18337,11,2020-03-16,48865,106,216.92417886012484,115,216.92417886012484
Faroe Islands,2020,18344,12,2020-03-23,48865,44,90.0439987721273,159,90.0439987721273
Faroe Islands,2020,18351,13,2020-03-30,48865,22,45.02199938606365,181,45.02199938606365
Faroe Islands,2020,18358,14,2020-04-06,48865,3,6.139363552645042,184,6.139363552645042
Faroe Islands,2020,18365,15,2020-04-13,48865,1,2.0464545175483475,185,2.0464545175483475
Faroe Islands,2020,18372,16,2020-04-20,48865,2,4.092909035096695,187,4.092909035096695
Faroe Islands,2020,18379,17,2020-04-27,48865,0,0,187,0
Faroe Islands,2020,18386,18,2020-05-04,48865,0,0,187,0
Faroe Islands,2020,18393,19,2020-05-11,48865,0,0,187,0
Faroe Islands,2020,18400,20,2020-05-18,48865,0,0,187,0
Faroe Islands,2020,18407,21,2020-05-25,48865,0,0,187,0
Faroe Islands,2020,18414,22,2020-06-01,48865,0,0,187,0
Faroe Islands,2020,18421,23,2020-06-08,48865,0,0,187,0
Faroe Islands,2020,18428,24,2020-06-15,48865,0,0,187,0
Faroe Islands,2020,18435,25,2020-06-22,48865,0,0,187,0
Faroe Islands,2020,18442,26,2020-06-29,48865,0,0,187,0
Faroe Islands,2020,18449,27,2020-07-06,48865,1,2.0464545175483475,188,2.0464545175483475
Faroe Islands,2020,18456,28,2020-07-13,48865,3,6.139363552645042,191,6.139363552645042
Faroe Islands,2020,18463,29,2020-07-20,48865,0,0,191,0
Faroe Islands,2020,18470,30,2020-07-27,48865,34,69.57945359664382,225,69.57945359664382
Faroe Islands,2020,18477,31,2020-08-03,48865,66,135.06599815819092,291,135.06599815819092
Faroe Islands,2020,18484,32,2020-08-10,48865,81,165.76281592141615,372,165.76281592141615
Faroe Islands,2020,18491,33,2020-08-17,48865,12,24.55745421058017,384,24.55745421058017
Faroe Islands,2020,18498,34,2020-08-24,48865,27,55.25427197380538,411,55.25427197380538
Faroe Islands,2020,18505,35,2020-08-31,48865,2,4.092909035096695,413,4.092909035096695
Faroe Islands,2020,18512,36,2020-09-07,48865,10,20.464545175483476,423,20.464545175483476
Faroe Islands,2020,18519,37,2020-09-14,48865,11,22.510999693031824,434,22.510999693031824
Faroe Islands,2020,18526,38,2020-09-21,48865,26,53.20781745625703,460,53.20781745625703
Faroe Islands,2020,18533,39,2020-09-28,48865,14,28.650363245676864,474,28.650363245676864
Faroe Islands,2020,18540,40,2020-10-05,48865,3,6.139363552645042,477,6.139363552645042
Faroe Islands,2020,18547,41,2020-10-12,48865,8,16.37163614038678,485,16.37163614038678
Faroe Islands,2020,18554,42,2020-10-19,48865,5,10.232272587741738,490,10.232272587741738
Faroe Islands,2020,18561,43,2020-10-26,48865,5,10.232272587741738,495,10.232272587741738
Faroe Islands,2020,18568,44,2020-11-02,48865,2,4.092909035096695,497,4.092909035096695
Faroe Islands,2020,18575,45,2020-11-09,48865,1,2.0464545175483475,498,2.0464545175483475
Faroe Islands,2020,18582,46,2020-11-16,48865,2,4.092909035096695,500,4.092909035096695
Faroe Islands,2020,18589,47,2020-11-23,48865,2,4.092909035096695,502,4.092909035096695
Faroe Islands,2020,18596,48,2020-11-30,48865,8,16.37163614038678,510,16.37163614038678
Faroe Islands,2020,18603,49,2020-12-07,48865,18,36.836181315870256,528,36.836181315870256
Faroe Islands,2020,18610,50,2020-12-14,48865,18,36.836181315870256,546,36.836181315870256
Faroe Islands,2020,18617,51,2020-12-21,48865,36,73.67236263174051,582,73.67236263174051
Faroe Islands,2020,18624,52,2020-12-28,48865,38,77.76527166683721,620,77.76527166683721
Faroe Islands,2021,18631,0,2021-01-04,48865,26,53.20781745625703,646,53.20781745625703
Faroe Islands,2021,18631,1,2021-01-04,48865,3,6.139363552645042,649,6.139363552645042
Faroe Islands,2021,18638,2,2021-01-11,48865,3,6.139363552645042,652,6.139363552645042
Faroe Islands,2021,18645,3,2021-01-18,48865,2,4.092909035096695,654,4.092909035096695
Faroe Islands,2021,18652,4,2021-01-25,48865,2,4.092909035096695,656,4.092909035096695
Faroe Islands,2021,18659,5,2021-02-01,48865,1,2.0464545175483475,657,2.0464545175483475
Faroe Islands,2021,18666,6,2021-02-08,48865,1,2.0464545175483475,658,2.0464545175483475
Faroe Islands,2021,18673,7,2021-02-15,48865,0,0,658,0
Faroe Islands,2021,18680,8,2021-02-22,48865,2,4.092909035096695,660,4.092909035096695
Faroe Islands,2021,18687,9,2021-03-01,48865,1,2.0464545175483475,661,2.0464545175483475
Faroe Islands,2021,18694,10,2021-03-08,48865,0,0,661,0
Faroe Islands,2021,18701,11,2021-03-15,48865,0,0,661,0
Faroe Islands,2021,18708,12,2021-03-22,48865,0,0,661,0
Faroe Islands,2021,18715,13,2021-03-29,48865,0,0,661,0
Faroe Islands,2021,18722,14,2021-04-05,48865,1,2.0464545175483475,662,2.0464545175483475
Faroe Islands,2021,18729,15,2021-04-12,48865,1,2.0464545175483475,663,2.0464545175483475
Faroe Islands,2021,18736,16,2021-04-19,48865,1,2.0464545175483475,664,2.0464545175483475
Faroe Islands,2021,18743,17,2021-04-26,48865,4,8.18581807019339,668,8.18581807019339
Faroe Islands,2021,18750,18,2021-05-03,48865,2,4.092909035096695,670,4.092909035096695
Faroe Islands,2021,18757,19,2021-05-10,48865,22,45.02199938606365,692,45.02199938606365
Faroe Islands,2021,18764,20,2021-05-17,48865,26,53.20781745625703,718,53.20781745625703
Faroe Islands,2021,18771,21,2021-05-24,48865,26,53.20781745625703,744,53.20781745625703
Faroe Islands,2021,18778,22,2021-05-31,48865,12,24.55745421058017,756,24.55745421058017
Faroe Islands,2021,18785,23,2021-06-07,48865,12,24.55745421058017,768,24.55745421058017
Faroe Islands,2021,18792,24,2021-06-14,48865,4,8.18581807019339,772,8.18581807019339
Faroe Islands,2021,18799,25,2021-06-21,48865,12,24.55745421058017,784,24.55745421058017
Faroe Islands,2021,18806,26,2021-06-28,48865,84,171.9021794740612,868,171.9021794740612
Faroe Islands,2021,18813,27,2021-07-05,48865,65,133.01954364064258,933,133.01954364064258
Faroe Islands,2021,18820,28,2021-07-12,48865,40,81.8581807019339,973,81.8581807019339
Faroe Islands,2021,18827,29,2021-07-19,48865,12,24.55745421058017,985,24.55745421058017
Faroe Islands,2021,18834,30,2021-07-26,48865,4,8.18581807019339,989,8.18581807019339
Faroe Islands,2021,18841,31,2021-08-02,48865,3,6.139363552645042,992,6.139363552645042
Faroe Islands,2021,18848,32,2021-08-09,48865,5,10.232272587741738,997,10.232272587741738
Faroe Islands,2021,18855,33,2021-08-16,48865,3,6.139363552645042,1000,6.139363552645042
Faroe Islands,2021,18862,34,2021-08-23,48865,20,40.92909035096695,1020,40.92909035096695
Faroe Islands,2021,18869,35,2021-08-30,48865,17,34.78972679832191,1037,34.78972679832191
Faroe Islands,2021,18876,36,2021-09-06,48865,33,67.53299907909546,1070,67.53299907909546
Faroe Islands,2021,18883,37,2021-09-13,48865,57,116.64790750025581,1127,116.64790750025581
Faroe Islands,2021,18890,38,2021-09-20,48865,93,190.32027013199632,1220,190.32027013199632
Faroe Islands,2021,18897,39,2021-09-27,48865,73,149.39117978102936,1293,149.39117978102936
Faroe Islands,2021,18904,40,2021-10-04,48865,57,116.64790750025581,1350,116.64790750025581
Faroe Islands,2021,18911,41,2021-10-11,48865,265,542.310447150312,1615,542.310447150312
Faroe Islands,2021,18918,42,2021-10-18,48865,597,1221.7333469763635,2212,1221.7333469763635
Faroe Islands,2021,18925,43,2021-10-25,48865,455,931.1368054844982,2667,931.1368054844982
Finland,2020,18267,0,2020-01-06,5525292,0,0,0,0
Finland,2020,18267,1,2020-01-06,5525292,0,0,0,0
Finland,2020,18274,2,2020-01-13,5525292,0,0,0,0
Finland,2020,18281,3,2020-01-20,5525292,0,0,0,0
Finland,2020,18288,4,2020-01-27,5525292,1,0.018098590988494364,1,0.018098590988494364
Finland,2020,18295,5,2020-02-03,5525292,0,0,1,0
Finland,2020,18302,6,2020-02-10,5525292,0,0,1,0
Finland,2020,18309,7,2020-02-17,5525292,0,0,1,0
Finland,2020,18316,8,2020-02-24,5525292,6,0.10859154593096618,7,0.10859154593096618
Finland,2020,18323,9,2020-03-02,5525292,32,0.5791549116318196,39,0.5791549116318196
Finland,2020,18330,10,2020-03-09,5525292,304,5.501971660502287,343,5.501971660502287
Finland,2020,18337,11,2020-03-16,5525292,512,9.266478586109114,855,9.266478586109114
Finland,2020,18344,12,2020-03-23,5525292,601,10.877253184085113,1456,10.877253184085113
Finland,2020,18351,13,2020-03-30,5525292,907,16.41542202656439,2363,16.41542202656439
Finland,2020,18358,14,2020-04-06,5525292,897,16.234436116679444,3260,16.234436116679444
Finland,2020,18365,15,2020-04-13,5525292,754,13.64633760532475,4014,13.64633760532475
Finland,2020,18372,16,2020-04-20,5525292,721,13.049084102704436,4735,13.049084102704436
Finland,2020,18379,17,2020-04-27,5525292,607,10.985844730016078,5342,10.985844730016078
Finland,2020,18386,18,2020-05-04,5525292,593,10.732464456177158,5935,10.732464456177158
Finland,2020,18393,19,2020-05-11,5525292,362,6.55168993783496,6297,6.55168993783496
Finland,2020,18400,20,2020-05-18,5525292,199,3.6016196067103783,6496,3.6016196067103783
Finland,2020,18407,21,2020-05-25,5525292,144,2.6061971023431885,6640,2.6061971023431885
Finland,2020,18414,22,2020-06-01,5525292,93,1.683168961929976,6733,1.683168961929976
Finland,2020,18421,23,2020-06-08,5525292,45,0.8144365944822464,6778,0.8144365944822464
Finland,2020,18428,24,2020-06-15,5525292,46,0.8325351854707407,6824,0.8325351854707407
Finland,2020,18435,25,2020-06-22,5525292,44,0.7963380034937521,6868,0.7963380034937521
Finland,2020,18442,26,2020-06-29,5525292,38,0.6877464575627859,6906,0.6877464575627859
Finland,2020,18449,27,2020-07-06,5525292,38,0.6877464575627859,6944,0.6877464575627859
Finland,2020,18456,28,2020-07-13,5525292,38,0.6877464575627859,6982,0.6877464575627859
Finland,2020,18463,29,2020-07-20,5525292,50,0.9049295494247181,7032,0.9049295494247181
Finland,2020,18470,30,2020-07-27,5525292,74,1.3392957331485829,7106,1.3392957331485829
Finland,2020,18477,31,2020-08-03,5525292,156,2.8233801942051207,7262,2.8233801942051207
Finland,2020,18484,32,2020-08-10,5525292,157,2.841478785193615,7419,2.841478785193615
Finland,2020,18491,33,2020-08-17,5525292,174,3.149154831998019,7593,3.149154831998019
Finland,2020,18498,34,2020-08-24,5525292,149,2.69669005728566,7742,2.69669005728566
Finland,2020,18505,35,2020-08-31,5525292,224,4.054084381422737,7966,4.054084381422737
Finland,2020,18512,36,2020-09-07,5525292,344,6.225915300042061,8310,6.225915300042061
Finland,2020,18519,37,2020-09-14,5525292,456,8.25295749075343,8766,8.25295749075343
Finland,2020,18526,38,2020-09-21,5525292,702,12.705210873923043,9468,12.705210873923043
Finland,2020,18533,39,2020-09-28,5525292,1101,19.926548678332296,10569,19.926548678332296
Finland,2020,18540,40,2020-10-05,5525292,1595,28.86725262664851,12164,28.86725262664851
Finland,2020,18547,41,2020-10-12,5525292,1241,22.460351416721505,13405,22.460351416721505
Finland,2020,18554,42,2020-10-19,5525292,1232,22.297464097825056,14637,22.297464097825056
Finland,2020,18561,43,2020-10-26,5525292,1434,25.953379477500917,16071,25.953379477500917
Finland,2020,18568,44,2020-11-02,5525292,1378,24.939858382145232,17449,24.939858382145232
Finland,2020,18575,45,2020-11-09,5525292,1627,29.44640753828033,19076,29.44640753828033
Finland,2020,18582,46,2020-11-16,5525292,2560,46.33239293054557,21636,46.33239293054557
Finland,2020,18589,47,2020-11-23,5525292,3096,56.03323770037855,24732,56.03323770037855
Finland,2020,18596,48,2020-11-30,5525292,2966,53.68042087187428,27698,53.68042087187428
Finland,2020,18603,49,2020-12-07,5525292,2873,51.99725190994431,30571,51.99725190994431
Finland,2020,18610,50,2020-12-14,5525292,2288,41.40957618167511,32859,41.40957618167511
Finland,2020,18617,51,2020-12-21,5525292,1619,29.301618810372375,34478,29.301618810372375
Finland,2020,18624,52,2020-12-28,5525292,1720,31.129576500210305,36198,31.129576500210305
Finland,2021,18631,0,2021-01-04,5525292,1811,32.77654828016329,38009,32.77654828016329
Finland,2021,18631,1,2021-01-04,5525292,1736,31.419153956026214,39745,31.419153956026214
Finland,2021,18638,2,2021-01-11,5525292,2324,42.0611254572609,42069,42.0611254572609
Finland,2021,18645,3,2021-01-18,5525292,2688,48.64901257707285,44757,48.64901257707285
Finland,2021,18652,4,2021-01-25,5525292,2579,46.676266159326964,47336,46.676266159326964
Finland,2021,18659,5,2021-02-01,5525292,2517,45.554153518040316,49853,45.554153518040316
Finland,2021,18666,6,2021-02-08,5525292,3500,63.34506845973027,53353,63.34506845973027
Finland,2021,18673,7,2021-02-15,5525292,3946,71.41704004059876,57299,71.41704004059876
Finland,2021,18680,8,2021-02-22,5525292,4420,79.99577216914508,61719,79.99577216914508
Finland,2021,18687,9,2021-03-01,5525292,4897,88.6288000706569,66616,88.6288000706569
Finland,2021,18694,10,2021-03-08,5525292,4657,84.28513823341825,71273,84.28513823341825
Finland,2021,18701,11,2021-03-15,5525292,4138,74.89196951038967,75411,74.89196951038967
Finland,2021,18708,12,2021-03-22,5525292,3231,58.47654748382529,78642,58.47654748382529
Finland,2021,18715,13,2021-03-29,5525292,2524,45.68084365495977,81166,45.68084365495977
Finland,2021,18722,14,2021-04-05,5525292,1906,34.49591442407026,83072,34.49591442407026
Finland,2021,18729,15,2021-04-12,5525292,1590,28.77675967170604,84662,28.77675967170604
Finland,2021,18736,16,2021-04-19,5525292,1366,24.722675290283302,86028,24.722675290283302
Finland,2021,18743,17,2021-04-26,5525292,1480,26.78591466297166,87508,26.78591466297166
Finland,2021,18750,18,2021-05-03,5525292,1398,25.30183020191512,88906,25.30183020191512
Finland,2021,18757,19,2021-05-10,5525292,1299,23.510069694054177,90205,23.510069694054177
Finland,2021,18764,20,2021-05-17,5525292,879,15.908661478886545,91084,15.908661478886545
Finland,2021,18771,21,2021-05-24,5525292,705,12.759506646888527,91789,12.759506646888527
Finland,2021,18778,22,2021-05-31,5525292,524,9.483661677971046,92313,9.483661677971046
Finland,2021,18785,23,2021-06-07,5525292,519,9.393168723028575,92832,9.393168723028575
Finland,2021,18792,24,2021-06-14,5525292,960,17.37464734895459,93792,17.37464734895459
Finland,2021,18799,25,2021-06-21,5525292,1267,22.93091478242236,95059,22.93091478242236
Finland,2021,18806,26,2021-06-28,5525292,1662,30.079858222877633,96721,30.079858222877633
Finland,2021,18813,27,2021-07-05,5525292,2229,40.34175931335394,98950,40.34175931335394
Finland,2021,18820,28,2021-07-12,5525292,2897,52.43161809366817,101847,52.43161809366817
Finland,2021,18827,29,2021-07-19,5525292,4601,83.27161713806257,106448,83.27161713806257
Finland,2021,18834,30,2021-07-26,5525292,5055,91.48837744683901,111503,91.48837744683901
Finland,2021,18841,31,2021-08-02,5525292,5121,92.68288445207963,116624,92.68288445207963
Finland,2021,18848,32,2021-08-09,5525292,4313,78.05922293337619,120937,78.05922293337619
Finland,2021,18855,33,2021-08-16,5525292,4125,74.65668782753924,125062,74.65668782753924
Finland,2021,18862,34,2021-08-23,5525292,3829,69.29950489494492,128891,69.29950489494492
Finland,2021,18869,35,2021-08-30,5525292,3084,55.816054608516616,131975,55.816054608516616
Finland,2021,18876,36,2021-09-06,5525292,2765,50.042604083186916,134740,50.042604083186916
Finland,2021,18883,37,2021-09-13,5525292,2974,53.82520959978224,137714,53.82520959978224
Finland,2021,18890,38,2021-09-20,5525292,3855,69.77006826064577,141569,69.77006826064577
Finland,2021,18897,39,2021-09-27,5525292,4206,76.1226736976073,145775,76.1226736976073
Finland,2021,18904,40,2021-10-04,5525292,3683,66.65711061062474,149458,66.65711061062474
Finland,2021,18911,41,2021-10-11,5525292,3645,65.96936415306196,153103,65.96936415306196
Finland,2021,18918,42,2021-10-18,5525292,4136,74.85577232841268,157239,74.85577232841268
Finland,2021,18925,43,2021-10-25,5525292,5106,92.41140558725222,162345,92.41140558725222
France,2020,18267,0,2020-01-06,67320216,0,0,0,0
France,2020,18267,1,2020-01-06,67320216,0,0,0,0
France,2020,18274,2,2020-01-13,67320216,0,0,0,0
France,2020,18281,3,2020-01-20,67320216,3,0.0044563136874070635,3,0.0044563136874070635
France,2020,18288,4,2020-01-27,67320216,3,0.0044563136874070635,6,0.0044563136874070635
France,2020,18295,5,2020-02-03,67320216,6,0.008912627374814127,12,0.008912627374814127
France,2020,18302,6,2020-02-10,67320216,0,0,12,0
France,2020,18309,7,2020-02-17,67320216,4,0.005941751583209418,16,0.005941751583209418
France,2020,18316,8,2020-02-24,67320216,133,0.19756324014171314,149,0.19756324014171314
France,2020,18323,9,2020-03-02,67320216,981,1.4572145757821098,1130,1.4572145757821098
France,2020,18330,10,2020-03-09,67320216,4297,6.382926638262718,5427,6.382926638262718
France,2020,18337,11,2020-03-16,67320216,11266,16.734943334109325,16693,16.734943334109325
France,2020,18344,12,2020-03-23,67320216,23485,34.885508982918296,40178,34.885508982918296
France,2020,18351,13,2020-03-30,67320216,31002,46.051545645664596,71180,46.051545645664596
France,2020,18358,14,2020-04-06,67320216,25898,38.46987062548938,97078,38.46987062548938
France,2020,18365,15,2020-04-13,67320216,16220,24.09380266991419,113298,24.09380266991419
France,2020,18372,16,2020-04-20,67320216,11120,16.518069401322183,124418,16.518069401322183
France,2020,18379,17,2020-04-27,67320216,6144,9.126530431809666,130562,9.126530431809666
France,2020,18386,18,2020-05-04,67320216,4046,6.010081726416327,134608,6.010081726416327
France,2020,18393,19,2020-05-11,67320216,3392,5.038605342561587,138000,5.038605342561587
France,2020,18400,20,2020-05-18,67320216,4663,6.926596908126379,142663,6.926596908126379
France,2020,18407,21,2020-05-25,67320216,4005,5.9491787726884295,146668,5.9491787726884295
France,2020,18414,22,2020-06-01,67320216,3169,4.707352691797661,149837,4.707352691797661
France,2020,18421,23,2020-06-08,67320216,3282,4.875207174023328,153119,4.875207174023328
France,2020,18428,24,2020-06-15,67320216,3558,5.285188033264777,156677,5.285188033264777
France,2020,18435,25,2020-06-22,67320216,3575,5.310440477493417,160252,5.310440477493417
France,2020,18442,26,2020-06-29,67320216,3832,5.692198016714623,164084,5.692198016714623
France,2020,18449,27,2020-07-06,67320216,3994,5.932838955834604,168078,5.932838955834604
France,2020,18456,28,2020-07-13,67320216,4503,6.688926844798003,172581,6.688926844798003
France,2020,18463,29,2020-07-20,67320216,6628,9.845482373378006,179209,9.845482373378006
France,2020,18470,30,2020-07-27,67320216,8503,12.630678428007421,187712,12.630678428007421
France,2020,18477,31,2020-08-03,67320216,11908,17.68859446321444,199620,17.68859446321444
France,2020,18484,32,2020-08-10,67320216,17306,25.70698822475555,216926,25.70698822475555
France,2020,18491,33,2020-08-17,67320216,28123,41.774969943649616,245049,41.774969943649616
France,2020,18498,34,2020-08-24,67320216,39812,59.13825350768334,284861,59.13825350768334
France,2020,18505,35,2020-08-31,67320216,52783,78.40586845413569,337644,78.40586845413569
France,2020,18512,36,2020-09-07,67320216,64661,96.04989978047604,402305,96.04989978047604
France,2020,18519,37,2020-09-14,67320216,75740,112.50706622807033,478045,112.50706622807033
France,2020,18526,38,2020-09-21,67320216,74047,109.99221987047694,552092,109.99221987047694
France,2020,18533,39,2020-09-28,67320216,79885,118.6642063061711,631977,118.6642063061711
France,2020,18540,40,2020-10-05,67320216,123001,182.71034662158542,754978,182.71034662158542
France,2020,18547,41,2020-10-12,67320216,174734,259.5565052851286,929712,259.5565052851286
France,2020,18554,42,2020-10-19,67320216,275387,409.070285811323,1205099,409.070285811323
France,2020,18561,43,2020-10-26,67320216,334435,496.7824226826604,1539534,496.7824226826604
France,2020,18568,44,2020-11-02,67320216,304537,452.37080047396165,1844071,452.37080047396165
France,2020,18575,45,2020-11-09,67320216,178236,264.75850879622845,2022307,264.75850879622845
France,2020,18582,46,2020-11-16,67320216,116361,172.84703899345777,2138668,172.84703899345777
France,2020,18589,47,2020-11-23,67320216,78220,116.19095220966017,2216888,116.19095220966017
France,2020,18596,48,2020-11-30,67320216,72108,107.11195579051618,2288996,107.11195579051618
France,2020,18603,49,2020-12-07,67320216,78718,116.93070028176975,2367714,116.93070028176975
France,2020,18610,50,2020-12-14,67320216,94277,140.04262850255859,2461991,140.04262850255859
France,2020,18617,51,2020-12-21,67320216,85079,126.37957073696852,2547070,126.37957073696852
France,2020,18624,52,2020-12-28,67320216,89718,133.27051713559564,2636788,133.27051713559564
France,2021,18631,0,2021-01-04,67320216,123772,183.85561923924902,2760560,183.85561923924902
France,2021,18631,1,2021-01-04,67320216,120584,179.12004322743113,2881144,179.12004322743113
France,2021,18638,2,2021-01-11,67320216,132681,197.0893854529522,3013825,197.0893854529522
France,2021,18645,3,2021-01-18,67320216,134201,199.34725105457179,3148026,199.34725105457179
France,2021,18652,4,2021-01-25,67320216,131725,195.66930682456515,3279751,195.66930682456515
France,2021,18659,5,2021-02-01,67320216,114493,170.07224100409897,3394244,170.07224100409897
France,2021,18666,6,2021-02-08,67320216,120503,178.99972275787113,3514747,178.99972275787113
France,2021,18673,7,2021-02-15,67320216,130574,193.95956780649664,3645321,193.95956780649664
France,2021,18680,8,2021-02-22,67320216,126996,188.64467101531582,3772317,188.64467101531582
France,2021,18687,9,2021-03-01,67320216,144682,214.91612564047625,3916999,214.91612564047625
France,2021,18694,10,2021-03-08,67320216,185651,275.7730307936029,4102650,275.7730307936029
France,2021,18701,11,2021-03-15,67320216,226062,335.8010616008719,4328712,335.8010616008719
France,2021,18708,12,2021-03-22,67320216,244764,363.5817211281675,4573476,363.5817211281675
France,2021,18715,13,2021-03-29,67320216,205781,305.67489563610434,4779257,305.67489563610434
France,2021,18722,14,2021-04-05,67320216,205146,304.73164257226983,4984403,304.73164257226983
France,2021,18729,15,2021-04-12,67320216,182669,271.3434549883203,5167072,271.3434549883203
France,2021,18736,16,2021-04-19,67320216,146243,217.23489419582373,5313315,217.23489419582373
France,2021,18743,17,2021-04-26,67320216,109638,162.86044001997854,5422953,162.86044001997854
France,2021,18750,18,2021-05-03,67320216,83970,124.73222011052371,5506923,124.73222011052371
France,2021,18757,19,2021-05-10,67320216,85248,126.63060974135912,5592171,126.63060974135912
France,2021,18764,20,2021-05-17,67320216,63203,93.88413132839621,5655374,93.88413132839621
France,2021,18771,21,2021-05-24,67320216,48785,72.46708774671787,5704159,72.46708774671787
France,2021,18778,22,2021-05-31,67320216,29159,43.31388360370086,5733318,43.31388360370086
France,2021,18785,23,2021-06-07,67320216,17105,25.408415207699274,5750423,25.408415207699274
France,2021,18792,24,2021-06-14,67320216,12713,18.884371969335334,5763136,18.884371969335334
France,2021,18799,25,2021-06-21,67320216,15589,23.156491357662905,5778725,23.156491357662905
France,2021,18806,26,2021-06-28,67320216,25502,37.88163721875164,5804227,37.88163721875164
France,2021,18813,27,2021-07-05,67320216,50628,75.20474978868161,5854855,75.20474978868161
France,2021,18820,28,2021-07-12,67320216,122142,181.43435546909117,5976997,181.43435546909117
France,2021,18827,29,2021-07-19,67320216,152489,226.51293929300525,6129486,226.51293929300525
France,2021,18834,30,2021-07-26,67320216,158002,234.70215841256362,6287488,234.70215841256362
France,2021,18841,31,2021-08-02,67320216,165856,246.3687876461953,6453344,246.3687876461953
France,2021,18848,32,2021-08-09,67320216,149413,221.9437323255172,6602757,221.9437323255172
France,2021,18855,33,2021-08-16,67320216,124937,185.58615438785876,6727694,185.58615438785876
France,2021,18862,34,2021-08-23,67320216,95297,141.557775156277,6822991,141.557775156277
France,2021,18869,35,2021-08-30,67320216,70528,104.76496391514846,6893519,104.76496391514846
France,2021,18876,36,2021-09-06,67320216,51050,75.83160458071019,6944569,75.83160458071019
France,2021,18883,37,2021-09-13,67320216,39645,58.89018537908434,6984214,58.89018537908434
France,2021,18890,38,2021-09-20,67320216,33450,49.687897614588756,7017664,49.687897614588756
France,2021,18897,39,2021-09-27,67320216,29187,43.35547586478332,7046851,43.35547586478332
France,2021,18904,40,2021-10-04,67320216,32723,48.607984264340445,7079574,48.607984264340445
France,2021,18911,41,2021-10-11,67320216,35967,53.426744798323284,7115541,53.426744798323284
France,2021,18918,42,2021-10-18,67320216,39727,59.01199128654014,7155268,59.01199128654014
France,2021,18925,43,2021-10-25,67320216,49239,73.14147655141214,7204507,73.14147655141214
Georgia,2020,18267,0,2020-01-06,3989175,0,0,0,0
Georgia,2020,18267,1,2020-01-06,3989175,0,0,0,0
Georgia,2020,18274,2,2020-01-13,3989175,0,0,0,0
Georgia,2020,18281,3,2020-01-20,3989175,0,0,0,0
Georgia,2020,18288,4,2020-01-27,3989175,0,0,0,0
Georgia,2020,18295,5,2020-02-03,3989175,0,0,0,0
Georgia,2020,18302,6,2020-02-10,3989175,0,0,0,0
Georgia,2020,18309,7,2020-02-17,3989175,0,0,0,0
Georgia,2020,18316,8,2020-02-24,3989175,3,0.075203519524713755,3,0.075203519524713755
Georgia,2020,18323,9,2020-03-02,3989175,10,0.25067839841571254,13,0.25067839841571254
Georgia,2020,18330,10,2020-03-09,3989175,17,0.42615327730671126,30,0.42615327730671126
Georgia,2020,18337,11,2020-03-16,3989175,24,0.60162815619771,54,0.60162815619771
Georgia,2020,18344,12,2020-03-23,3989175,36,0.9024422342965651,90,0.9024422342965651
Georgia,2020,18351,13,2020-03-30,3989175,84,2.1056985466919853,174,2.1056985466919853
Georgia,2020,18358,14,2020-04-06,3989175,83,2.080630706850414,257,2.080630706850414
Georgia,2020,18365,15,2020-04-13,3989175,137,3.4342940582952615,394,3.4342940582952615
Georgia,2020,18372,16,2020-04-20,3989175,92,2.306241265424555,486,2.306241265424555
Georgia,2020,18379,17,2020-04-27,3989175,103,2.581987503681839,589,2.581987503681839
Georgia,2020,18386,18,2020-05-04,3989175,46,1.1531206327122776,635,1.1531206327122776
Georgia,2020,18393,19,2020-05-11,3989175,66,1.6544774295437026,701,1.6544774295437026
Georgia,2020,18400,20,2020-05-18,3989175,29,0.7269673554055663,730,0.7269673554055663
Georgia,2020,18407,21,2020-05-25,3989175,53,1.3285955116032764,783,1.3285955116032764
Georgia,2020,18414,22,2020-06-01,3989175,25,0.6266959960392813,808,0.6266959960392813
Georgia,2020,18421,23,2020-06-08,3989175,71,1.7798166287515589,879,1.7798166287515589
Georgia,2020,18428,24,2020-06-15,3989175,29,0.7269673554055663,908,0.7269673554055663
Georgia,2020,18435,25,2020-06-22,3989175,18,0.45122111714828256,926,0.45122111714828256
Georgia,2020,18442,26,2020-06-29,3989175,27,0.6768316757224239,953,0.6768316757224239
Georgia,2020,18449,27,2020-07-06,3989175,42,1.0528492733459927,995,1.0528492733459927
Georgia,2020,18456,28,2020-07-13,3989175,33,0.8272387147718513,1028,0.8272387147718513
Georgia,2020,18463,29,2020-07-20,3989175,109,2.7323945427312664,1137,2.7323945427312664
Georgia,2020,18470,30,2020-07-27,3989175,40,1.0027135936628502,1177,1.0027135936628502
Georgia,2020,18477,31,2020-08-03,3989175,73,1.8299523084347014,1250,1.8299523084347014
Georgia,2020,18484,32,2020-08-10,3989175,91,2.281173425582984,1341,2.281173425582984
Georgia,2020,18491,33,2020-08-17,3989175,70,1.7547487889099878,1411,1.7547487889099878
Georgia,2020,18498,34,2020-08-24,3989175,76,1.9051558279594152,1487,1.9051558279594152
Georgia,2020,18505,35,2020-08-31,3989175,153,3.8353794957604017,1640,3.8353794957604017
Georgia,2020,18512,36,2020-09-07,3989175,752,18.851015560861583,2392,18.851015560861583
Georgia,2020,18519,37,2020-09-14,3989175,1303,32.66339531356734,3695,32.66339531356734
Georgia,2020,18526,38,2020-09-21,3989175,1857,46.550978585797814,5552,46.550978585797814
Georgia,2020,18533,39,2020-09-28,3989175,2566,64.32407703347184,8118,64.32407703347184
Georgia,2020,18540,40,2020-10-05,3989175,3676,92.14937925761592,11794,92.14937925761592
Georgia,2020,18547,41,2020-10-12,3989175,5683,142.4605338196494,17477,142.4605338196494
Georgia,2020,18554,42,2020-10-19,3989175,12826,321.52011380799286,30303,321.52011380799286
Georgia,2020,18561,43,2020-10-26,3989175,12276,307.7328018951287,42579,307.7328018951287
Georgia,2020,18568,44,2020-11-02,3989175,18101,453.7529689722812,60680,453.7529689722812
Georgia,2020,18575,45,2020-11-09,3989175,22155,555.3779916900111,82835,555.3779916900111
Georgia,2020,18582,46,2020-11-16,3989175,25855,648.1289991038248,108690,648.1289991038248
Georgia,2020,18589,47,2020-11-23,3989175,26894,674.1744846992173,135584,674.1744846992173
Georgia,2020,18596,48,2020-11-30,3989175,29392,736.7939486234623,164976,736.7939486234623
Georgia,2020,18603,49,2020-12-07,3989175,26087,653.9447379470693,191063,653.9447379470693
Georgia,2020,18610,50,2020-12-14,3989175,18399,461.2231852450695,209462,461.2231852450695
Georgia,2020,18617,51,2020-12-21,3989175,12681,317.885277030965,222143,317.885277030965
Georgia,2020,18624,52,2020-12-28,3989175,7620,191.01693959277293,229763,191.01693959277293
Georgia,2021,18631,0,2021-01-04,3989175,10017,251.10455169301923,239780,251.10455169301923
Georgia,2021,18631,1,2021-01-04,3989175,8135,203.92687711118214,247915,203.92687711118214
Georgia,2021,18638,2,2021-01-11,3989175,5901,147.92532290511195,253816,147.92532290511195
Georgia,2021,18645,3,2021-01-18,3989175,4535,113.68265368152562,258351,113.68265368152562
Georgia,2021,18652,4,2021-01-25,3989175,3877,97.18801506577175,262228,97.18801506577175
Georgia,2021,18659,5,2021-02-01,3989175,3494,87.58703240644995,265722,87.58703240644995
Georgia,2021,18666,6,2021-02-08,3989175,2780,69.68859475956808,268502,69.68859475956808
Georgia,2021,18673,7,2021-02-15,3989175,2416,60.563901057236144,270918,60.563901057236144
Georgia,2021,18680,8,2021-02-22,3989175,2080,52.14110687046821,272998,52.14110687046821
Georgia,2021,18687,9,2021-03-01,3989175,2150,53.89585565937819,275148,53.89585565937819
Georgia,2021,18694,10,2021-03-08,3989175,2502,62.71973528361127,277650,62.71973528361127
Georgia,2021,18701,11,2021-03-15,3989175,2651,66.45484342000539,280301,66.45484342000539
Georgia,2021,18708,12,2021-03-22,3989175,3760,94.2550778043079,284061,94.2550778043079
Georgia,2021,18715,13,2021-03-29,3989175,4335,108.66908571321137,288396,108.66908571321137
Georgia,2021,18722,14,2021-04-05,3989175,7540,189.01151240544723,295936,189.01151240544723
Georgia,2021,18729,15,2021-04-12,3989175,8336,208.96551291933795,304272,208.96551291933795
Georgia,2021,18736,16,2021-04-19,3989175,8682,217.6389855045216,312954,217.6389855045216
Georgia,2021,18743,17,2021-04-26,3989175,8965,224.73318417968628,321919,224.73318417968628
Georgia,2021,18750,18,2021-05-03,3989175,8456,211.9736537003265,330375,211.9736537003265
Georgia,2021,18757,19,2021-05-10,3989175,7586,190.1646330381595,337961,190.1646330381595
Georgia,2021,18764,20,2021-05-17,3989175,6002,150.45717472911065,343963,150.45717472911065
Georgia,2021,18771,21,2021-05-24,3989175,5442,136.41918441783076,349405,136.41918441783076
Georgia,2021,18778,22,2021-05-31,3989175,4871,122.10544786829357,354276,122.10544786829357
Georgia,2021,18785,23,2021-06-07,3989175,4605,115.43740247043561,358881,115.43740247043561
Georgia,2021,18792,24,2021-06-14,3989175,4993,125.16372432896526,363874,125.16372432896526
Georgia,2021,18799,25,2021-06-21,3989175,5174,129.70100334028965,369048,129.70100334028965
Georgia,2021,18806,26,2021-06-28,3989175,8763,219.6694805316889,377811,219.6694805316889
Georgia,2021,18813,27,2021-07-05,3989175,10518,263.6635394536464,388329,263.6635394536464
Georgia,2021,18820,28,2021-07-12,3989175,15694,393.41467847361923,404023,393.41467847361923
Georgia,2021,18827,29,2021-07-19,3989175,19820,496.8445856599422,423843,496.8445856599422
Georgia,2021,18834,30,2021-07-26,3989175,24070,603.38290498662,447913,603.38290498662
Georgia,2021,18841,31,2021-08-02,3989175,33665,843.9088282664962,481578,843.9088282664962
Georgia,2021,18848,32,2021-08-09,3989175,33166,831.3999761855522,514744,831.3999761855522
Georgia,2021,18855,33,2021-08-16,3989175,28374,711.2748876647427,543118,711.2748876647427
Georgia,2021,18862,34,2021-08-23,3989175,22839,572.5243941416459,565957,572.5243941416459
Georgia,2021,18869,35,2021-08-30,3989175,15858,397.5258042076369,581815,397.5258042076369
Georgia,2021,18876,36,2021-09-06,3989175,13449,337.13737802929177,595264,337.13737802929177
Georgia,2021,18883,37,2021-09-13,3989175,11891,298.0816835561238,607155,298.0816835561238
Georgia,2021,18890,38,2021-09-20,3989175,11465,287.4027837836144,618620,287.4027837836144
Georgia,2021,18897,39,2021-09-27,3989175,16963,425.22576723257316,635583,425.22576723257316
Georgia,2021,18904,40,2021-10-04,3989175,29230,732.7329585691277,664813,732.7329585691277
Georgia,2021,18911,41,2021-10-11,3989175,27427,687.5356433347747,692240,687.5356433347747
Georgia,2021,18918,42,2021-10-18,3989175,29148,730.6773957021188,721388,730.6773957021188
Georgia,2021,18925,43,2021-10-25,3989175,33658,843.7333533876052,755046,843.7333533876052
Germany,2020,18267,0,2020-01-06,83166711,1,0.001202404168658299,1,0.001202404168658299
Germany,2020,18267,1,2020-01-06,83166711,0,0,1,0
Germany,2020,18274,2,2020-01-13,83166711,0,0,1,0
Germany,2020,18281,3,2020-01-20,83166711,1,0.001202404168658299,2,0.001202404168658299
Germany,2020,18288,4,2020-01-27,83166711,9,0.01082163751792469,11,0.01082163751792469
Germany,2020,18295,5,2020-02-03,83166711,8,0.009619233349266391,19,0.009619233349266391
Germany,2020,18302,6,2020-02-10,83166711,2,0.002404808337316598,21,0.002404808337316598
Germany,2020,18309,7,2020-02-17,83166711,4,0.004809616674633196,25,0.004809616674633196
Germany,2020,18316,8,2020-02-24,83166711,139,0.16713417944350353,164,0.16713417944350353
Germany,2020,18323,9,2020-03-02,83166711,899,1.0809613476238107,1063,1.0809613476238107
Germany,2020,18330,10,2020-03-09,83166711,6431,7.73266120864152,7494,7.73266120864152
Germany,2020,18337,11,2020-03-16,83166711,22389,26.920626932090652,29883,26.920626932090652
Germany,2020,18344,12,2020-03-23,83166711,33965,40.83965758847912,63848,40.83965758847912
Germany,2020,18351,13,2020-03-30,83166711,36049,43.34546787596302,99897,43.34546787596302
Germany,2020,18358,14,2020-04-06,83166711,27131,32.62242749986831,127028,32.62242749986831
Germany,2020,18365,15,2020-04-13,83166711,17325,20.83165222200503,144353,20.83165222200503
Germany,2020,18372,16,2020-04-20,83166711,12348,14.847286674592674,156701,14.847286674592674
Germany,2020,18379,17,2020-04-27,83166711,7427,8.930255760625185,164128,8.930255760625185
Germany,2020,18386,18,2020-05-04,83166711,6234,7.495787587415835,170362,7.495787587415835
Germany,2020,18393,19,2020-05-11,83166711,4758,5.721039034476186,175120,5.721039034476186
Germany,2020,18400,20,2020-05-18,83166711,3598,4.326250198832559,178718,4.326250198832559
Germany,2020,18407,21,2020-05-25,83166711,3204,3.8525029563811897,181922,3.8525029563811897
Germany,2020,18414,22,2020-06-01,83166711,2351,2.8268522005156607,184273,2.8268522005156607
Germany,2020,18421,23,2020-06-08,83166711,2342,2.816030562997736,186615,2.816030562997736
Germany,2020,18428,24,2020-06-15,83166711,4190,5.038073466678272,190805,5.038073466678272
Germany,2020,18435,25,2020-06-22,83166711,3155,3.793585152116933,193960,3.793585152116933
Germany,2020,18442,26,2020-06-29,83166711,2687,3.230860001184849,196647,3.230860001184849
Germany,2020,18449,27,2020-07-06,83166711,2422,2.9122228964904,199069,2.9122228964904
Germany,2020,18456,28,2020-07-13,83166711,3025,3.637272610191354,202094,3.637272610191354
Germany,2020,18463,29,2020-07-20,83166711,3926,4.720638766152481,206020,4.720638766152481
Germany,2020,18470,30,2020-07-27,83166711,4834,5.812421751294217,210854,5.812421751294217
Germany,2020,18477,31,2020-08-03,83166711,6059,7.285366857900633,216913,7.285366857900633
Germany,2020,18484,32,2020-08-10,83166711,7954,9.56392275750811,224867,9.56392275750811
Germany,2020,18491,33,2020-08-17,83166711,9595,11.537067998276378,234462,11.537067998276378
Germany,2020,18498,34,2020-08-24,83166711,8827,10.613621596746803,243289,10.613621596746803
Germany,2020,18505,35,2020-08-31,83166711,8612,10.35510470048527,251901,10.35510470048527
Germany,2020,18512,36,2020-09-07,83166711,9760,11.735464686104997,261661,11.735464686104997
Germany,2020,18519,37,2020-09-14,83166711,12289,14.776344828641834,273950,14.776344828641834
Germany,2020,18526,38,2020-09-21,83166711,13063,15.707005655183359,287013,15.707005655183359
Germany,2020,18533,39,2020-09-28,83166711,15925,19.14828638588341,302938,19.14828638588341
Germany,2020,18540,40,2020-10-05,83166711,26113,31.398380056174158,329051,31.398380056174158
Germany,2020,18547,41,2020-10-12,83166711,42061,50.57432173793671,371112,50.57432173793671
Germany,2020,18554,42,2020-10-19,83166711,74869,90.02279770327817,445981,90.02279770327817
Germany,2020,18561,43,2020-10-26,83166711,111018,133.48850599610702,556999,133.48850599610702
Germany,2020,18568,44,2020-11-02,83166711,125731,151.17947852957658,682730,151.17947852957658
Germany,2020,18575,45,2020-11-09,83166711,127795,153.6612407336873,810525,153.6612407336873
Germany,2020,18582,46,2020-11-16,83166711,128376,154.35983755567779,938901,154.35983755567779
Germany,2020,18589,47,2020-11-23,83166711,123158,148.08569260361878,1062059,148.08569260361878
Germany,2020,18596,48,2020-11-30,83166711,128351,154.32977745146133,1190410,154.32977745146133
Germany,2020,18603,49,2020-12-07,83166711,156295,187.92975954044883,1346705,187.92975954044883
Germany,2020,18610,50,2020-12-14,83166711,174704,210.06481788127945,1521409,210.06481788127945
Germany,2020,18617,51,2020-12-21,83166711,138949,167.07285683090197,1660358,167.07285683090197
Germany,2020,18624,52,2020-12-28,83166711,114239,137.3614498233554,1774597,137.3614498233554
Germany,2021,18631,0,2021-01-04,83166711,145443,174.88126950216898,1920040,174.88126950216898
Germany,2021,18631,1,2021-01-04,83166711,118880,142.94180757009858,2038920,142.94180757009858
Germany,2021,18638,2,2021-01-11,83166711,95519,114.85244378607204,2134439,114.85244378607204
Germany,2021,18645,3,2021-01-18,83166711,78122,93.93421846392363,2212561,93.93421846392363
Germany,2021,18652,4,2021-01-25,83166711,64552,77.61759389523051,2277113,77.61759389523051
Germany,2021,18659,5,2021-02-01,83166711,50802,61.0845365761789,2327915,61.0845365761789
Germany,2021,18666,6,2021-02-08,83166711,52385,62.987942375164984,2380300,62.987942375164984
Germany,2021,18673,7,2021-02-15,83166711,56349,67.75427249972648,2436649,67.75427249972648
Germany,2021,18680,8,2021-02-22,83166711,58369,70.18312892041625,2495018,70.18312892041625
Germany,2021,18687,9,2021-03-01,83166711,71311,85.74464367119195,2566329,85.74464367119195
Germany,2021,18694,10,2021-03-08,83166711,92583,111.32218514689129,2658912,111.32218514689129
Germany,2021,18701,11,2021-03-15,83166711,116272,139.80593749823774,2775184,139.80593749823774
Germany,2021,18708,12,2021-03-22,83166711,110097,132.38109175677272,2885281,132.38109175677272
Germany,2021,18715,13,2021-03-29,83166711,118272,142.21074583555432,3003553,142.21074583555432
Germany,2021,18722,14,2021-04-05,83166711,142054,170.806321774586,3145607,170.806321774586
Germany,2021,18729,15,2021-04-12,83166711,144753,174.05161062579472,3290360,174.05161062579472
Germany,2021,18736,16,2021-04-19,83166711,124786,150.04320659019447,3415146,150.04320659019447
Germany,2021,18743,17,2021-04-26,83166711,100980,121.41877295111502,3516126,121.41877295111502
Germany,2021,18750,18,2021-05-03,83166711,70804,85.13502475768219,3586930,85.13502475768219
Germany,2021,18757,19,2021-05-10,83166711,52698,63.36429487995503,3639628,63.36429487995503
Germany,2021,18764,20,2021-05-17,83166711,29876,35.923026942835335,3669504,35.923026942835335
Germany,2021,18771,21,2021-05-24,83166711,20678,24.863313399516304,3690182,24.863313399516304
Germany,2021,18778,22,2021-05-31,83166711,14032,16.87213529461325,3704214,16.87213529461325
Germany,2021,18785,23,2021-06-07,83166711,7271,8.742680710314492,3711485,8.742680710314492
Germany,2021,18792,24,2021-06-14,83166711,4818,5.793183284595684,3716303,5.793183284595684
Germany,2021,18799,25,2021-06-21,83166711,3497,4.204807377798071,3719800,4.204807377798071
Germany,2021,18806,26,2021-06-28,83166711,5576,6.704605644438675,3725376,6.704605644438675
Germany,2021,18813,27,2021-07-05,83166711,9100,10.94187793479052,3734476,10.94187793479052
Germany,2021,18820,28,2021-07-12,83166711,12626,15.18155503347968,3747102,15.18155503347968
Germany,2021,18827,29,2021-07-19,83166711,15500,18.637264614203634,3762602,18.637264614203634
Germany,2021,18834,30,2021-07-26,83166711,20413,24.544676294821855,3783015,24.544676294821855
Germany,2021,18841,31,2021-08-02,83166711,32060,38.549077647185065,3815075,38.549077647185065
Germany,2021,18848,32,2021-08-09,83166711,49621,59.66449725299345,3864696,59.66449725299345
Germany,2021,18855,33,2021-08-16,83166711,66331,79.75667091127362,3931027,79.75667091127362
Germany,2021,18862,34,2021-08-23,83166711,74675,89.78953129455847,4005702,89.78953129455847
Germany,2021,18869,35,2021-08-30,83166711,71656,86.15947310937906,4077358,86.15947310937906
Germany,2021,18876,36,2021-09-06,83166711,61436,73.87090250569125,4138794,73.87090250569125
Germany,2021,18883,37,2021-09-13,83166711,53599,64.44766103591616,4192393,64.44766103591616
Germany,2021,18890,38,2021-09-20,83166711,56455,67.88172734160426,4248848,67.88172734160426
Germany,2021,18897,39,2021-09-27,83166711,57936,69.6624879153872,4306784,69.6624879153872
Germany,2021,18904,40,2021-10-04,83166711,65241,78.44605036743607,4372025,78.44605036743607
Germany,2021,18911,41,2021-10-11,83166711,97428,117.14783334404075,4469453,117.14783334404075
Germany,2021,18918,42,2021-10-18,83166711,136802,164.4912950807926,4606255,164.4912950807926
Germany,2021,18925,43,2021-10-25,83166711,177641,213.59627892462888,4783896,213.59627892462888
Gibraltar,2020,18337,11,2020-03-16,33691,15,44.522275978748034,15,44.522275978748034
Gibraltar,2020,18344,12,2020-03-23,33691,50,148.40758659582679,65,148.40758659582679
Gibraltar,2020,18351,13,2020-03-30,33691,38,112.78976581282835,103,112.78976581282835
Gibraltar,2020,18358,14,2020-04-06,33691,26,77.17194502982993,129,77.17194502982993
Gibraltar,2020,18365,15,2020-04-13,33691,4,11.872606927666142,133,11.872606927666142
Gibraltar,2020,18372,16,2020-04-20,33691,8,23.745213855332285,141,23.745213855332285
Gibraltar,2020,18379,17,2020-04-27,33691,3,8.904455195749607,144,8.904455195749607
Gibraltar,2020,18386,18,2020-05-04,33691,2,5.936303463833071,146,5.936303463833071
Gibraltar,2020,18393,19,2020-05-11,33691,1,2.9681517319165356,147,2.9681517319165356
Gibraltar,2020,18400,20,2020-05-18,33691,4,11.872606927666142,151,11.872606927666142
Gibraltar,2020,18407,21,2020-05-25,33691,18,53.42673117449764,169,53.42673117449764
Gibraltar,2020,18414,22,2020-06-01,33691,6,17.808910391499214,175,17.808910391499214
Gibraltar,2020,18421,23,2020-06-08,33691,1,2.9681517319165356,176,2.9681517319165356
Gibraltar,2020,18428,24,2020-06-15,33691,0,0,176,0
Gibraltar,2020,18435,25,2020-06-22,33691,1,2.9681517319165356,177,2.9681517319165356
Gibraltar,2020,18442,26,2020-06-29,33691,1,2.9681517319165356,178,2.9681517319165356
Gibraltar,2020,18449,27,2020-07-06,33691,2,5.936303463833071,180,5.936303463833071
Gibraltar,2020,18456,28,2020-07-13,33691,0,0,180,0
Gibraltar,2020,18463,29,2020-07-20,33691,5,14.840758659582677,185,14.840758659582677
Gibraltar,2020,18470,30,2020-07-27,33691,3,8.904455195749607,188,8.904455195749607
Gibraltar,2020,18477,31,2020-08-03,33691,9,26.71336558724882,197,26.71336558724882
Gibraltar,2020,18484,32,2020-08-10,33691,18,53.42673117449764,215,53.42673117449764
Gibraltar,2020,18491,33,2020-08-17,33691,14,41.5541242468315,229,41.5541242468315
Gibraltar,2020,18498,34,2020-08-24,33691,56,166.216496987326,285,166.216496987326
Gibraltar,2020,18505,35,2020-08-31,33691,30,89.04455195749607,315,89.04455195749607
Gibraltar,2020,18512,36,2020-09-07,33691,15,44.522275978748034,330,44.522275978748034
Gibraltar,2020,18519,37,2020-09-14,33691,20,59.36303463833071,350,59.36303463833071
Gibraltar,2020,18526,38,2020-09-21,33691,29,86.07640022557953,379,86.07640022557953
Gibraltar,2020,18533,39,2020-09-28,33691,53,157.31204179157638,432,157.31204179157638
Gibraltar,2020,18540,40,2020-10-05,33691,53,157.31204179157638,485,157.31204179157638
Gibraltar,2020,18547,41,2020-10-12,33691,86,255.26104894482205,571,255.26104894482205
Gibraltar,2020,18554,42,2020-10-19,33691,96,284.94256626398743,667,284.94256626398743
Gibraltar,2020,18561,43,2020-10-26,33691,36,106.85346234899528,703,106.85346234899528
Gibraltar,2020,18568,44,2020-11-02,33691,90,267.1336558724882,793,267.1336558724882
Gibraltar,2020,18575,45,2020-11-09,33691,109,323.5285387789024,902,323.5285387789024
Gibraltar,2020,18582,46,2020-11-16,33691,56,166.216496987326,958,166.216496987326
Gibraltar,2020,18589,47,2020-11-23,33691,56,166.216496987326,1014,166.216496987326
Gibraltar,2020,18596,48,2020-11-30,33691,39,115.75791754474488,1053,115.75791754474488
Gibraltar,2020,18603,49,2020-12-07,33691,22,65.29933810216379,1075,65.29933810216379
Gibraltar,2020,18610,50,2020-12-14,33691,169,501.61764269389454,1244,501.61764269389454
Gibraltar,2020,18617,51,2020-12-21,33691,462,1371.2861001454394,1706,1371.2861001454394
Gibraltar,2020,18624,52,2020-12-28,33691,700,2077.706212341575,2406,2077.706212341575
Gibraltar,2021,18631,0,2021-01-04,33691,764,2267.667923184233,3170,2267.667923184233
Gibraltar,2021,18631,1,2021-01-04,33691,500,1484.0758659582677,3670,1484.0758659582677
Gibraltar,2021,18638,2,2021-01-11,33691,296,878.5729126472945,3966,878.5729126472945
Gibraltar,2021,18645,3,2021-01-18,33691,148,439.28645632364726,4114,439.28645632364726
Gibraltar,2021,18652,4,2021-01-25,33691,73,216.6750764299071,4187,216.6750764299071
Gibraltar,2021,18659,5,2021-02-01,33691,32,94.98085542132914,4219,94.98085542132914
Gibraltar,2021,18666,6,2021-02-08,33691,9,26.71336558724882,4228,26.71336558724882
Gibraltar,2021,18673,7,2021-02-15,33691,11,32.649669051081894,4239,32.649669051081894
Gibraltar,2021,18680,8,2021-02-22,33691,10,29.681517319165355,4249,29.681517319165355
Gibraltar,2021,18687,9,2021-03-01,33691,14,41.5541242468315,4263,41.5541242468315
Gibraltar,2021,18694,10,2021-03-08,33691,7,20.77706212341575,4270,20.77706212341575
Gibraltar,2021,18701,11,2021-03-15,33691,3,8.904455195749607,4273,8.904455195749607
Gibraltar,2021,18708,12,2021-03-22,33691,2,5.936303463833071,4275,5.936303463833071
Gibraltar,2021,18715,13,2021-03-29,33691,2,5.936303463833071,4277,5.936303463833071
Gibraltar,2021,18722,14,2021-04-05,33691,6,17.808910391499214,4283,17.808910391499214
Gibraltar,2021,18729,15,2021-04-12,33691,0,0,4283,0
Gibraltar,2021,18736,16,2021-04-19,33691,0,0,4283,0
Gibraltar,2021,18743,17,2021-04-26,33691,3,8.904455195749607,4286,8.904455195749607
Gibraltar,2021,18750,18,2021-05-03,33691,0,0,4286,0
Gibraltar,2021,18757,19,2021-05-10,33691,2,5.936303463833071,4288,5.936303463833071
Gibraltar,2021,18764,20,2021-05-17,33691,5,14.840758659582677,4293,14.840758659582677
Gibraltar,2021,18771,21,2021-05-24,33691,7,20.77706212341575,4300,20.77706212341575
Gibraltar,2021,18778,22,2021-05-31,33691,12,35.61782078299843,4312,35.61782078299843
Gibraltar,2021,18785,23,2021-06-07,33691,9,26.71336558724882,4321,26.71336558724882
Gibraltar,2021,18792,24,2021-06-14,33691,24,71.23564156599686,4345,71.23564156599686
Gibraltar,2021,18799,25,2021-06-21,33691,21,62.331186370247245,4366,62.331186370247245
Gibraltar,2021,18806,26,2021-06-28,33691,64,189.96171084265828,4430,189.96171084265828
Gibraltar,2021,18813,27,2021-07-05,33691,165,489.7450357662284,4595,489.7450357662284
Gibraltar,2021,18820,28,2021-07-12,33691,204,605.5029533109732,4799,605.5029533109732
Gibraltar,2021,18827,29,2021-07-19,33691,181,537.235463476893,4980,537.235463476893
Gibraltar,2021,18834,30,2021-07-26,33691,147,436.31830459173074,5127,436.31830459173074
Gibraltar,2021,18841,31,2021-08-02,33691,85,252.29289721290553,5212,252.29289721290553
Gibraltar,2021,18848,32,2021-08-09,33691,75,222.61137989374018,5287,222.61137989374018
Gibraltar,2021,18855,33,2021-08-16,33691,51,151.3757383277433,5338,151.3757383277433
Gibraltar,2021,18862,34,2021-08-23,33691,0,0,5338,0
Gibraltar,2021,18869,35,2021-08-30,33691,93,276.0381110682378,5431,276.0381110682378
Gibraltar,2021,18876,36,2021-09-06,33691,46,136.53497966816064,5477,136.53497966816064
Gibraltar,2021,18883,37,2021-09-13,33691,37,109.82161408091181,5514,109.82161408091181
Gibraltar,2021,18890,38,2021-09-20,33691,59,175.1209521830756,5573,175.1209521830756
Gibraltar,2021,18897,39,2021-09-27,33691,53,157.31204179157638,5626,157.31204179157638
Gibraltar,2021,18904,40,2021-10-04,33691,132,391.7960286129827,5758,391.7960286129827
Gibraltar,2021,18911,41,2021-10-11,33691,116,344.30560090231813,5874,344.30560090231813
Gibraltar,2021,18918,42,2021-10-18,33691,118,350.2419043661512,5992,350.2419043661512
Gibraltar,2021,18925,43,2021-10-25,33691,161,477.8724288385622,6153,477.8724288385622
Greece,2020,18267,0,2020-01-06,10718565,0,0,0,0
Greece,2020,18267,1,2020-01-06,10718565,0,0,0,0
Greece,2020,18274,2,2020-01-13,10718565,0,0,0,0
Greece,2020,18281,3,2020-01-20,10718565,0,0,0,0
Greece,2020,18288,4,2020-01-27,10718565,0,0,0,0
Greece,2020,18295,5,2020-02-03,10718565,0,0,0,0
Greece,2020,18302,6,2020-02-10,10718565,0,0,0,0
Greece,2020,18309,7,2020-02-17,10718565,0,0,0,0
Greece,2020,18316,8,2020-02-24,10718565,6,0.05597764252957369,6,0.05597764252957369
Greece,2020,18323,9,2020-03-02,10718565,80,0.7463685670609825,86,0.7463685670609825
Greece,2020,18330,10,2020-03-09,10718565,318,2.9668150540674056,404,2.9668150540674056
Greece,2020,18337,11,2020-03-16,10718565,374,3.4892730510100933,778,3.4892730510100933
Greece,2020,18344,12,2020-03-23,10718565,535,4.99133979222032,1313,4.99133979222032
Greece,2020,18351,13,2020-03-30,10718565,528,4.926032542602485,1841,4.926032542602485
Greece,2020,18358,14,2020-04-06,10718565,288,2.686926841419537,2129,2.686926841419537
Greece,2020,18365,15,2020-04-13,10718565,117,1.0915640293266868,2246,1.0915640293266868
Greece,2020,18372,16,2020-04-20,10718565,299,2.7895525193904223,2545,2.7895525193904223
Greece,2020,18379,17,2020-04-27,10718565,103,0.960949530091015,2648,0.960949530091015
Greece,2020,18386,18,2020-05-04,10718565,99,0.9236311017379658,2747,0.9236311017379658
Greece,2020,18393,19,2020-05-11,10718565,104,0.9702791371792773,2851,0.9702791371792773
Greece,2020,18400,20,2020-05-18,10718565,47,0.43849153314832723,2898,0.43849153314832723
Greece,2020,18407,21,2020-05-25,10718565,46,0.4291619260600649,2944,0.4291619260600649
Greece,2020,18414,22,2020-06-01,10718565,135,1.259496956915408,3079,1.259496956915408
Greece,2020,18421,23,2020-06-08,10718565,120,1.1195528505914738,3199,1.1195528505914738
Greece,2020,18428,24,2020-06-15,10718565,114,1.0635752080619,3313,1.0635752080619
Greece,2020,18435,25,2020-06-22,10718565,119,1.1102232435032116,3432,1.1102232435032116
Greece,2020,18442,26,2020-06-29,10718565,203,1.893910238917243,3635,1.893910238917243
Greece,2020,18449,27,2020-07-06,10718565,257,2.3977090216834065,3892,2.3977090216834065
Greece,2020,18456,28,2020-07-13,10718565,175,1.6326812404458992,4067,1.6326812404458992
Greece,2020,18463,29,2020-07-20,10718565,246,2.295083343712521,4313,2.295083343712521
Greece,2020,18470,30,2020-07-27,10718565,560,5.224579969426878,4873,5.224579969426878
Greece,2020,18477,31,2020-08-03,10718565,1080,10.075975655323264,5953,10.075975655323264
Greece,2020,18484,32,2020-08-10,10718565,1594,14.871393698690076,7547,14.871393698690076
Greece,2020,18491,33,2020-08-17,10718565,1662,15.505806980691911,9209,15.505806980691911
Greece,2020,18498,34,2020-08-24,10718565,1445,13.481282242538997,10654,13.481282242538997
Greece,2020,18505,35,2020-08-31,10718565,1342,12.520332712447981,11996,12.520332712447981
Greece,2020,18512,36,2020-09-07,10718565,1758,16.40144926116509,13754,16.40144926116509
Greece,2020,18519,37,2020-09-14,10718565,2235,20.8516718422662,15989,20.8516718422662
Greece,2020,18526,38,2020-09-21,10718565,2187,20.403850702029608,18176,20.403850702029608
Greece,2020,18533,39,2020-09-28,10718565,2390,22.29776094094685,20566,22.29776094094685
Greece,2020,18540,40,2020-10-05,10718565,2489,23.22139204268482,23055,23.22139204268482
Greece,2020,18547,41,2020-10-12,10718565,3345,31.20753571023733,26400,31.20753571023733
Greece,2020,18554,42,2020-10-19,10718565,6284,58.627250942640174,32684,58.627250942640174
Greece,2020,18561,43,2020-10-26,10718565,11249,104.9487501358624,43933,104.9487501358624
Greece,2020,18568,44,2020-11-02,10718565,17156,160.0587392062277,61089,160.0587392062277
Greece,2020,18575,45,2020-11-09,10718565,18251,170.2746589678749,79340,170.2746589678749
Greece,2020,18582,46,2020-11-16,10718565,16282,151.90466261108648,95622,151.90466261108648
Greece,2020,18589,47,2020-11-23,10718565,12246,114.25036840285989,107868,114.25036840285989
Greece,2020,18596,48,2020-11-30,10718565,10600,98.89383513558018,118468,98.89383513558018
Greece,2020,18603,49,2020-12-07,10718565,8291,77.35177236878258,126759,77.35177236878258
Greece,2020,18610,50,2020-12-14,10718565,6006,56.03362017210326,132765,56.03362017210326
Greece,2020,18617,51,2020-12-21,10718565,4285,39.97736637320388,137050,39.97736637320388
Greece,2020,18624,52,2020-12-28,10718565,4501,41.99256150426853,141551,41.99256150426853
Greece,2021,18631,0,2021-01-04,10718565,4614,43.046807105242166,146165,43.046807105242166
Greece,2021,18631,1,2021-01-04,10718565,3555,33.16675319877241,149720,33.16675319877241
Greece,2021,18638,2,2021-01-11,10718565,3365,31.394127852002576,153085,31.394127852002576
Greece,2021,18645,3,2021-01-18,10718565,5456,50.90233627355901,158541,50.90233627355901
Greece,2021,18652,4,2021-01-25,10718565,7426,69.2816622374357,165967,69.2816622374357
Greece,2021,18659,5,2021-02-01,10718565,8479,79.10573850137588,174446,79.10573850137588
Greece,2021,18666,6,2021-02-08,10718565,8127,75.82171680630756,182573,75.82171680630756
Greece,2021,18673,7,2021-02-15,10718565,11843,110.4905367462902,194416,110.4905367462902
Greece,2021,18680,8,2021-02-22,10718565,14533,135.58717981371572,208949,135.58717981371572
Greece,2021,18687,9,2021-03-01,10718565,16785,156.5974549764824,225734,156.5974549764824
Greece,2021,18694,10,2021-03-08,10718565,16547,154.37700848947597,242281,154.37700848947597
Greece,2021,18701,11,2021-03-15,10718565,17818,166.23493909865732,260099,166.23493909865732
Greece,2021,18708,12,2021-03-22,10718565,22222,207.32252871536443,282321,207.32252871536443
Greece,2021,18715,13,2021-03-29,10718565,20975,195.68850867630135,303296,195.68850867630135
Greece,2021,18722,14,2021-04-05,10718565,19732,184.09180706559133,323028,184.09180706559133
Greece,2021,18729,15,2021-04-12,10718565,18129,169.1364469031069,341157,169.1364469031069
Greece,2021,18736,16,2021-04-19,10718565,14746,137.5743861235156,355903,137.5743861235156
Greece,2021,18743,17,2021-04-26,10718565,15251,142.28583770308805,371154,142.28583770308805
Greece,2021,18750,18,2021-05-03,10718565,15053,140.4385754996121,386207,140.4385754996121
Greece,2021,18757,19,2021-05-10,10718565,12431,115.97634571418843,398638,115.97634571418843
Greece,2021,18764,20,2021-05-17,10718565,11019,102.80294050556208,409657,102.80294050556208
Greece,2021,18771,21,2021-05-24,10718565,7493,69.90674591234928,417150,69.90674591234928
Greece,2021,18778,22,2021-05-31,10718565,4936,46.05094058766262,422086,46.05094058766262
Greece,2021,18785,23,2021-06-07,10718565,3095,28.87513393817176,425181,28.87513393817176
Greece,2021,18792,24,2021-06-14,10718565,2572,23.995749431010587,427753,23.995749431010587
Greece,2021,18799,25,2021-06-21,10718565,5173,48.26205746758078,432926,48.26205746758078
Greece,2021,18806,26,2021-06-28,10718565,13657,127.41444400439798,446583,127.41444400439798
Greece,2021,18813,27,2021-07-05,10718565,17981,167.75566505404407,464564,167.75566505404407
Greece,2021,18820,28,2021-07-12,10718565,18094,168.80991065501772,482658,168.80991065501772
Greece,2021,18827,29,2021-07-19,10718565,18515,172.73767523917613,501173,172.73767523917613
Greece,2021,18834,30,2021-07-26,10718565,19583,182.70169560944026,520756,182.70169560944026
Greece,2021,18841,31,2021-08-02,10718565,22568,210.55057276790316,543324,210.55057276790316
Greece,2021,18848,32,2021-08-09,10718565,22384,208.83392506366292,565708,208.83392506366292
Greece,2021,18855,33,2021-08-16,10718565,21723,202.66705477832153,587431,202.66705477832153
Greece,2021,18862,34,2021-08-23,10718565,17532,163.5666714714143,604963,163.5666714714143
Greece,2021,18869,35,2021-08-30,10718565,14666,136.82801755645463,619629,136.82801755645463
Greece,2021,18876,36,2021-09-06,10718565,15259,142.36047455979414,634888,142.36047455979414
Greece,2021,18883,37,2021-09-13,10718565,14070,131.2675717318503,648958,131.2675717318503
Greece,2021,18890,38,2021-09-20,10718565,14936,139.34701147028542,663894,139.34701147028542
Greece,2021,18897,39,2021-09-27,10718565,15338,143.09751351976686,679232,143.09751351976686
Greece,2021,18904,40,2021-10-04,10718565,17447,162.77365486891202,696679,162.77365486891202
Greece,2021,18911,41,2021-10-11,10718565,22579,210.65319844587404,719258,210.65319844587404
Greece,2021,18918,42,2021-10-18,10718565,26653,248.6620177234546,745911,248.6620177234546
Greece,2021,18925,43,2021-10-25,10718565,43293,403.9066796721389,789204,403.9066796721389
Guernsey,2020,18337,11,2020-03-16,64468,17,26.36967177514426,17,26.36967177514426
Guernsey,2020,18344,12,2020-03-23,64468,28,43.432400570825834,45,43.432400570825834
Guernsey,2020,18351,13,2020-03-30,64468,109,169.076130793572,154,169.076130793572
Guernsey,2020,18358,14,2020-04-06,64468,64,99.27405844760192,218,99.27405844760192
Guernsey,2020,18365,15,2020-04-13,64468,21,32.57430042811938,239,32.57430042811938
Guernsey,2020,18372,16,2020-04-20,64468,8,12.40925730595024,247,12.40925730595024
Guernsey,2020,18379,17,2020-04-27,64468,5,7.755785816218899,252,7.755785816218899
Guernsey,2020,18386,18,2020-05-04,64468,0,0,252,0
Guernsey,2020,18393,19,2020-05-11,64468,0,0,252,0
Guernsey,2020,18400,20,2020-05-18,64468,0,0,252,0
Guernsey,2020,18407,21,2020-05-25,64468,0,0,252,0
Guernsey,2020,18414,22,2020-06-01,64468,0,0,252,0
Guernsey,2020,18421,23,2020-06-08,64468,0,0,252,0
Guernsey,2020,18428,24,2020-06-15,64468,0,0,252,0
Guernsey,2020,18435,25,2020-06-22,64468,0,0,252,0
Guernsey,2020,18442,26,2020-06-29,64468,0,0,252,0
Guernsey,2020,18449,27,2020-07-06,64468,0,0,252,0
Guernsey,2020,18456,28,2020-07-13,64468,0,0,252,0
Guernsey,2020,18463,29,2020-07-20,64468,0,0,252,0
Guernsey,2020,18470,30,2020-07-27,64468,0,0,252,0
Guernsey,2020,18477,31,2020-08-03,64468,0,0,252,0
Guernsey,2020,18484,32,2020-08-10,64468,0,0,252,0
Guernsey,2020,18491,33,2020-08-17,64468,0,0,252,0
Guernsey,2020,18498,34,2020-08-24,64468,0,0,252,0
Guernsey,2020,18505,35,2020-08-31,64468,0,0,252,0
Guernsey,2020,18512,36,2020-09-07,64468,1,1.55115716324378,253,1.55115716324378
Guernsey,2020,18519,37,2020-09-14,64468,2,3.10231432648756,255,3.10231432648756
Guernsey,2020,18526,38,2020-09-21,64468,1,1.55115716324378,256,1.55115716324378
Guernsey,2020,18533,39,2020-09-28,64468,1,1.55115716324378,257,1.55115716324378
Guernsey,2020,18540,40,2020-10-05,64468,1,1.55115716324378,258,1.55115716324378
Guernsey,2020,18547,41,2020-10-12,64468,0,0,258,0
Guernsey,2020,18554,42,2020-10-19,64468,7,10.858100142706459,265,10.858100142706459
Guernsey,2020,18561,43,2020-10-26,64468,5,7.755785816218899,270,7.755785816218899
Guernsey,2020,18568,44,2020-11-02,64468,9,13.960414469194019,279,13.960414469194019
Guernsey,2020,18575,45,2020-11-09,64468,3,4.65347148973134,282,4.65347148973134
Guernsey,2020,18582,46,2020-11-16,64468,1,1.55115716324378,283,1.55115716324378
Guernsey,2020,18589,47,2020-11-23,64468,3,4.65347148973134,286,4.65347148973134
Guernsey,2020,18596,48,2020-11-30,64468,2,3.10231432648756,288,3.10231432648756
Guernsey,2020,18603,49,2020-12-07,64468,1,1.55115716324378,289,1.55115716324378
Guernsey,2020,18610,50,2020-12-14,64468,4,6.20462865297512,293,6.20462865297512
Guernsey,2020,18617,51,2020-12-21,64468,4,6.20462865297512,297,6.20462865297512
Guernsey,2020,18624,52,2020-12-28,64468,3,4.65347148973134,300,4.65347148973134
Guernsey,2021,18631,0,2021-01-04,64468,5,7.755785816218899,305,7.755785816218899
Guernsey,2021,18631,1,2021-01-04,64468,4,6.20462865297512,309,6.20462865297512
Guernsey,2021,18638,2,2021-01-11,64468,12,18.61388595892536,321,18.61388595892536
Guernsey,2021,18645,3,2021-01-18,64468,218,338.152261587144,539,338.152261587144
Guernsey,2021,18652,4,2021-01-25,64468,202,313.3337469752435,741,313.3337469752435
Guernsey,2021,18659,5,2021-02-01,64468,56,86.86480114165167,797,86.86480114165167
Guernsey,2021,18666,6,2021-02-08,64468,16,24.81851461190048,813,24.81851461190048
Guernsey,2021,18673,7,2021-02-15,64468,8,12.40925730595024,821,12.40925730595024
Guernsey,2021,18680,8,2021-02-22,64468,0,0,821,0
Guernsey,2021,18687,9,2021-03-01,64468,0,0,821,0
Guernsey,2021,18694,10,2021-03-08,64468,0,0,821,0
Guernsey,2021,18701,11,2021-03-15,64468,0,0,821,0
Guernsey,2021,18708,12,2021-03-22,64468,0,0,821,0
Guernsey,2021,18715,13,2021-03-29,64468,0,0,821,0
Guernsey,2021,18722,14,2021-04-05,64468,1,1.55115716324378,822,1.55115716324378
Guernsey,2021,18729,15,2021-04-12,64468,0,0,822,0
Guernsey,2021,18736,16,2021-04-19,64468,0,0,822,0
Guernsey,2021,18743,17,2021-04-26,64468,0,0,822,0
Guernsey,2021,18750,18,2021-05-03,64468,0,0,822,0
Guernsey,2021,18757,19,2021-05-10,64468,0,0,822,0
Guernsey,2021,18764,20,2021-05-17,64468,1,1.55115716324378,823,1.55115716324378
Guernsey,2021,18771,21,2021-05-24,64468,0,0,823,0
Guernsey,2021,18778,22,2021-05-31,64468,2,3.10231432648756,825,3.10231432648756
Guernsey,2021,18785,23,2021-06-07,64468,2,3.10231432648756,827,3.10231432648756
Guernsey,2021,18792,24,2021-06-14,64468,8,12.40925730595024,835,12.40925730595024
Guernsey,2021,18799,25,2021-06-21,64468,12,18.61388595892536,847,18.61388595892536
Guernsey,2021,18806,26,2021-06-28,64468,10,15.511571632437798,857,15.511571632437798
Guernsey,2021,18813,27,2021-07-05,64468,37,57.392815040019855,894,57.392815040019855
Guernsey,2021,18820,28,2021-07-12,64468,35,54.290500713532296,929,54.290500713532296
Guernsey,2021,18827,29,2021-07-19,64468,27,41.881243407582055,956,41.881243407582055
Guernsey,2021,18834,30,2021-07-26,64468,51,79.10901532543278,1007,79.10901532543278
Guernsey,2021,18841,31,2021-08-02,64468,78,120.99025873301483,1085,120.99025873301483
Guernsey,2021,18848,32,2021-08-09,64468,95,147.3599305081591,1180,147.3599305081591
Guernsey,2021,18855,33,2021-08-16,64468,57,88.41595830489545,1237,88.41595830489545
Guernsey,2021,18862,34,2021-08-23,64468,138,214.0596885276416,1375,214.0596885276416
Guernsey,2021,18869,35,2021-08-30,64468,42,65.14860085623876,1417,65.14860085623876
Guernsey,2021,18876,36,2021-09-06,64468,84,130.29720171247752,1501,130.29720171247752
Guernsey,2021,18883,37,2021-09-13,64468,78,120.99025873301483,1579,120.99025873301483
Guernsey,2021,18890,38,2021-09-20,64468,68,105.47868710057703,1647,105.47868710057703
Guernsey,2021,18897,39,2021-09-27,64468,71,110.13215859030836,1718,110.13215859030836
Guernsey,2021,18904,40,2021-10-04,64468,99,153.5645591611342,1817,153.5645591611342
Guernsey,2021,18911,41,2021-10-11,64468,168,260.59440342495503,1985,260.59440342495503
Guernsey,2021,18918,42,2021-10-18,64468,185,286.9640752000993,2170,286.9640752000993
Guernsey,2021,18925,43,2021-10-25,64468,142,220.26431718061673,2312,220.26431718061673
Holy See,2020,18330,10,2020-03-09,809,1,123.60939431396787,1,123.60939431396787
Holy See,2020,18337,11,2020-03-16,809,0,0,1,0
Holy See,2020,18344,12,2020-03-23,809,5,618.0469715698393,6,618.0469715698393
Holy See,2020,18351,13,2020-03-30,809,1,123.60939431396787,7,123.60939431396787
Holy See,2020,18358,14,2020-04-06,809,1,123.60939431396787,8,123.60939431396787
Holy See,2020,18365,15,2020-04-13,809,0,0,8,0
Holy See,2020,18372,16,2020-04-20,809,1,123.60939431396787,9,123.60939431396787
Holy See,2020,18379,17,2020-04-27,809,2,247.21878862793574,11,247.21878862793574
Holy See,2020,18386,18,2020-05-04,809,1,123.60939431396787,12,123.60939431396787
Holy See,2020,18393,19,2020-05-11,809,0,0,12,0
Holy See,2020,18400,20,2020-05-18,809,0,0,12,0
Holy See,2020,18407,21,2020-05-25,809,0,0,12,0
Holy See,2020,18414,22,2020-06-01,809,0,0,12,0
Holy See,2020,18421,23,2020-06-08,809,0,0,12,0
Holy See,2020,18428,24,2020-06-15,809,0,0,12,0
Holy See,2020,18435,25,2020-06-22,809,0,0,12,0
Holy See,2020,18442,26,2020-06-29,809,0,0,12,0
Holy See,2020,18449,27,2020-07-06,809,0,0,12,0
Holy See,2020,18456,28,2020-07-13,809,0,0,12,0
Holy See,2020,18463,29,2020-07-20,809,0,0,12,0
Holy See,2020,18470,30,2020-07-27,809,0,0,12,0
Holy See,2020,18477,31,2020-08-03,809,0,0,12,0
Holy See,2020,18484,32,2020-08-10,809,0,0,12,0
Holy See,2020,18491,33,2020-08-17,809,0,0,12,0
Holy See,2020,18498,34,2020-08-24,809,0,0,12,0
Holy See,2020,18505,35,2020-08-31,809,0,0,12,0
Holy See,2020,18512,36,2020-09-07,809,0,0,12,0
Holy See,2020,18519,37,2020-09-14,809,0,0,12,0
Holy See,2020,18526,38,2020-09-21,809,0,0,12,0
Holy See,2020,18533,39,2020-09-28,809,0,0,12,0
Holy See,2020,18540,40,2020-10-05,809,0,0,12,0
Holy See,2020,18547,41,2020-10-12,809,15,1854.140914709518,27,1854.140914709518
Holy See,2020,18554,42,2020-10-19,809,0,0,27,0
Holy See,2020,18561,43,2020-10-26,809,0,0,27,0
Holy See,2020,18568,44,2020-11-02,809,0,0,27,0
Holy See,2020,18575,45,2020-11-09,809,0,0,27,0
Holy See,2020,18582,46,2020-11-16,809,0,0,27,0
Holy See,2020,18589,47,2020-11-23,809,0,0,27,0
Holy See,2020,18596,48,2020-11-30,809,0,0,27,0
Holy See,2020,18603,49,2020-12-07,809,0,0,27,0
Holy See,2020,18610,50,2020-12-14,809,0,0,27,0
Holy See,2020,18617,51,2020-12-21,809,0,0,27,0
Holy See,2020,18624,52,2020-12-28,809,0,0,27,0
Holy See,2021,18631,0,2021-01-04,809,0,0,27,0
Holy See,2021,18631,1,2021-01-04,809,0,0,27,0
Holy See,2021,18638,2,2021-01-11,809,0,0,27,0
Holy See,2021,18645,3,2021-01-18,809,0,0,27,0
Holy See,2021,18652,4,2021-01-25,809,0,0,27,0
Holy See,2021,18659,5,2021-02-01,809,0,0,27,0
Holy See,2021,18666,6,2021-02-08,809,0,0,27,0
Holy See,2021,18673,7,2021-02-15,809,0,0,27,0
Holy See,2021,18680,8,2021-02-22,809,0,0,27,0
Holy See,2021,18687,9,2021-03-01,809,0,0,27,0
Holy See,2021,18694,10,2021-03-08,809,0,0,27,0
Holy See,2021,18701,11,2021-03-15,809,0,0,27,0
Holy See,2021,18708,12,2021-03-22,809,0,0,27,0
Holy See,2021,18715,13,2021-03-29,809,0,0,27,0
Holy See,2021,18722,14,2021-04-05,809,0,0,27,0
Holy See,2021,18729,15,2021-04-12,809,0,0,27,0
Holy See,2021,18736,16,2021-04-19,809,0,0,27,0
Holy See,2021,18743,17,2021-04-26,809,0,0,27,0
Holy See,2021,18750,18,2021-05-03,809,0,0,27,0
Holy See,2021,18757,19,2021-05-10,809,0,0,27,0
Holy See,2021,18764,20,2021-05-17,809,0,0,27,0
Holy See,2021,18771,21,2021-05-24,809,0,0,27,0
Holy See,2021,18778,22,2021-05-31,809,0,0,27,0
Holy See,2021,18785,23,2021-06-07,809,0,0,27,0
Holy See,2021,18792,24,2021-06-14,809,0,0,27,0
Holy See,2021,18799,25,2021-06-21,809,0,0,27,0
Holy See,2021,18806,26,2021-06-28,809,0,0,27,0
Holy See,2021,18813,27,2021-07-05,809,0,0,27,0
Holy See,2021,18820,28,2021-07-12,809,0,0,27,0
Holy See,2021,18827,29,2021-07-19,809,0,0,27,0
Holy See,2021,18834,30,2021-07-26,809,0,0,27,0
Holy See,2021,18841,31,2021-08-02,809,0,0,27,0
Holy See,2021,18848,32,2021-08-09,809,0,0,27,0
Holy See,2021,18855,33,2021-08-16,809,0,0,27,0
Holy See,2021,18862,34,2021-08-23,809,0,0,27,0
Holy See,2021,18869,35,2021-08-30,809,0,0,27,0
Holy See,2021,18876,36,2021-09-06,809,0,0,27,0
Holy See,2021,18883,37,2021-09-13,809,0,0,27,0
Holy See,2021,18890,38,2021-09-20,809,0,0,27,0
Holy See,2021,18897,39,2021-09-27,809,0,0,27,0
Holy See,2021,18904,40,2021-10-04,809,0,0,27,0
Holy See,2021,18911,41,2021-10-11,809,0,0,27,0
Holy See,2021,18918,42,2021-10-18,809,0,0,27,0
Holy See,2021,18925,43,2021-10-25,809,0,0,27,0
Hungary,2020,18267,0,2020-01-06,9769526,0,0,0,0
Hungary,2020,18267,1,2020-01-06,9769526,0,0,0,0
Hungary,2020,18274,2,2020-01-13,9769526,0,0,0,0
Hungary,2020,18281,3,2020-01-20,9769526,0,0,0,0
Hungary,2020,18288,4,2020-01-27,9769526,0,0,0,0
Hungary,2020,18295,5,2020-02-03,9769526,0,0,0,0
Hungary,2020,18302,6,2020-02-10,9769526,0,0,0,0
Hungary,2020,18309,7,2020-02-17,9769526,0,0,0,0
Hungary,2020,18316,8,2020-02-24,9769526,0,0,0,0
Hungary,2020,18323,9,2020-03-02,9769526,9,0.09212320024533432,9,0.09212320024533432
Hungary,2020,18330,10,2020-03-09,9769526,30,0.3070773341511144,39,0.3070773341511144
Hungary,2020,18337,11,2020-03-16,9769526,126,1.2897248034346804,165,1.2897248034346804
Hungary,2020,18344,12,2020-03-23,9769526,279,2.855819207605364,444,2.855819207605364
Hungary,2020,18351,13,2020-03-30,9769526,296,3.029829696957662,740,3.029829696957662
Hungary,2020,18358,14,2020-04-06,9769526,711,7.277732819381411,1451,7.277732819381411
Hungary,2020,18365,15,2020-04-13,9769526,523,5.353381525367761,1974,5.353381525367761
Hungary,2020,18372,16,2020-04-20,9769526,602,6.162018505299029,2576,6.162018505299029
Hungary,2020,18379,17,2020-04-27,9769526,454,4.647103656820198,3030,4.647103656820198
Hungary,2020,18386,18,2020-05-04,9769526,249,2.5487418734542495,3279,2.5487418734542495
Hungary,2020,18393,19,2020-05-11,9769526,251,2.5692136957309906,3530,2.5692136957309906
Hungary,2020,18400,20,2020-05-18,9769526,220,2.2519004504415054,3750,2.2519004504415054
Hungary,2020,18407,21,2020-05-25,9769526,137,1.4023198259567557,3887,1.4023198259567557
Hungary,2020,18414,22,2020-06-01,9769526,122,1.2487811588811986,4009,1.2487811588811986
Hungary,2020,18421,23,2020-06-08,9769526,61,0.6243905794405993,4070,0.6243905794405993
Hungary,2020,18428,24,2020-06-15,9769526,32,0.32754915642785537,4102,0.32754915642785537
Hungary,2020,18435,25,2020-06-22,9769526,43,0.44014417894993063,4145,0.44014417894993063
Hungary,2020,18442,26,2020-06-29,9769526,44,0.4503800900883011,4189,0.4503800900883011
Hungary,2020,18449,27,2020-07-06,9769526,57,0.5834469348871173,4246,0.5834469348871173
Hungary,2020,18456,28,2020-07-13,9769526,90,0.9212320024533431,4336,0.9212320024533431
Hungary,2020,18463,29,2020-07-20,9769526,112,1.1464220474974938,4448,1.1464220474974938
Hungary,2020,18470,30,2020-07-27,9769526,96,0.982647469283566,4544,0.982647469283566
Hungary,2020,18477,31,2020-08-03,9769526,187,1.9141153828752797,4731,1.9141153828752797
Hungary,2020,18484,32,2020-08-10,9769526,215,2.200720894749653,4946,2.200720894749653
Hungary,2020,18491,33,2020-08-17,9769526,245,2.5077982289007674,5191,2.5077982289007674
Hungary,2020,18498,34,2020-08-24,9769526,948,9.703643759175215,6139,9.703643759175215
Hungary,2020,18505,35,2020-08-31,9769526,2814,28.80385394337453,8953,28.80385394337453
Hungary,2020,18512,36,2020-09-07,9769526,4197,42.9601190477409,13150,42.9601190477409
Hungary,2020,18519,37,2020-09-14,9769526,5706,58.40610895554196,18856,58.40610895554196
Hungary,2020,18526,38,2020-09-21,9769526,5855,59.93125971515916,24711,59.93125971515916
Hungary,2020,18533,39,2020-09-28,9769526,6761,69.20499520652281,31472,69.20499520652281
Hungary,2020,18540,40,2020-10-05,9769526,7360,75.33630597840673,38832,75.33630597840673
Hungary,2020,18547,41,2020-10-12,9769526,8931,91.41692237678676,47763,91.41692237678676
Hungary,2020,18554,42,2020-10-19,9769526,13797,141.2248659760975,61560,141.2248659760975
Hungary,2020,18561,43,2020-10-26,9769526,21208,217.08320342256113,82768,217.08320342256113
Hungary,2020,18568,44,2020-11-02,9769526,32004,327.59010007240886,114772,327.59010007240886
Hungary,2020,18575,45,2020-11-09,9769526,32677,334.47886826853215,147449,334.47886826853215
Hungary,2020,18582,46,2020-11-16,9769526,30498,312.17481789802287,177947,312.17481789802287
Hungary,2020,18589,47,2020-11-23,9769526,39173,400.9713470233868,217120,400.9713470233868
Hungary,2020,18596,48,2020-11-30,9769526,37025,378.98460989816704,254145,378.98460989816704
Hungary,2020,18603,49,2020-12-07,9769526,29698,303.9860889873265,283843,303.9860889873265
Hungary,2020,18610,50,2020-12-14,9769526,21255,217.56429124606456,305098,217.56429124606456
Hungary,2020,18617,51,2020-12-21,9769526,11534,118.06099906996512,316632,118.06099906996512
Hungary,2020,18624,52,2020-12-28,9769526,12180,124.67339766535244,328812,124.67339766535244
Hungary,2021,18631,0,2021-01-04,9769526,14805,151.54266440357495,343617,151.54266440357495
Hungary,2021,18631,1,2021-01-04,9769526,9047,92.60428806883773,352664,92.60428806883773
Hungary,2021,18638,2,2021-01-11,9769526,7713,78.94958261025151,360377,78.94958261025151
Hungary,2021,18645,3,2021-01-18,9769526,8290,84.85570333709127,368667,84.85570333709127
Hungary,2021,18652,4,2021-01-25,9769526,8944,91.54998922158558,377611,91.54998922158558
Hungary,2021,18659,5,2021-02-01,9769526,11173,114.36583514901336,388784,114.36583514901336
Hungary,2021,18666,6,2021-02-08,9769526,16714,171.0830187667242,405498,171.0830187667242
Hungary,2021,18673,7,2021-02-15,9769526,27374,280.1978315017535,432872,280.1978315017535
Hungary,2021,18680,8,2021-02-22,9769526,35792,366.3637314645562,468664,366.3637314645562
Hungary,2021,18687,9,2021-03-01,9769526,55481,567.8985858679326,524145,567.8985858679326
Hungary,2021,18694,10,2021-03-08,9769526,56441,577.7250605607683,580586,577.7250605607683
Hungary,2021,18701,11,2021-03-15,9769526,60477,619.0371979152316,641063,619.0371979152316
Hungary,2021,18708,12,2021-03-22,9769526,48756,499.0620834623911,689819,499.0620834623911
Hungary,2021,18715,13,2021-03-29,9769526,35412,362.47408523197544,725231,362.47408523197544
Hungary,2021,18722,14,2021-04-05,9769526,27952,286.11418813973165,753183,286.11418813973165
Hungary,2021,18729,15,2021-04-12,9769526,18283,187.14316334282748,771466,187.14316334282748
Hungary,2021,18736,16,2021-04-19,9769526,12716,130.15984603551902,784182,130.15984603551902
Hungary,2021,18743,17,2021-04-26,9769526,8275,84.70216467001572,792457,84.70216467001572
Hungary,2021,18750,18,2021-05-03,9769526,6197,63.43194132448186,798654,63.43194132448186
Hungary,2021,18757,19,2021-05-10,9769526,3773,38.62009272507182,802427,38.62009272507182
Hungary,2021,18764,20,2021-05-17,9769526,2192,22.437117215308092,804619,22.437117215308092
Hungary,2021,18771,21,2021-05-24,9769526,1551,15.875898175612614,806170,15.875898175612614
Hungary,2021,18778,22,2021-05-31,9769526,956,9.785531048282179,807126,9.785531048282179
Hungary,2021,18785,23,2021-06-07,9769526,585,5.988008015946731,807711,5.988008015946731
Hungary,2021,18792,24,2021-06-14,9769526,412,4.217195389008638,808123,4.217195389008638
Hungary,2021,18799,25,2021-06-21,9769526,220,2.2519004504415054,808343,2.2519004504415054
Hungary,2021,18806,26,2021-06-28,9769526,277,2.835347385328623,808620,2.835347385328623
Hungary,2021,18813,27,2021-07-05,9769526,325,3.3266711199704058,808945,3.3266711199704058
Hungary,2021,18820,28,2021-07-12,9769526,398,4.073892633071451,809343,4.073892633071451
Hungary,2021,18827,29,2021-07-19,9769526,384,3.930589877134264,809727,3.930589877134264
Hungary,2021,18834,30,2021-07-26,9769526,365,3.736107565505225,810092,3.736107565505225
Hungary,2021,18841,31,2021-08-02,9769526,493,5.046304191216646,810585,5.046304191216646
Hungary,2021,18848,32,2021-08-09,9769526,617,6.315557172374586,811202,6.315557172374586
Hungary,2021,18855,33,2021-08-16,9769526,1106,11.32091771903775,812308,11.32091771903775
Hungary,2021,18862,34,2021-08-23,9769526,1461,14.954666173159271,813769,14.954666173159271
Hungary,2021,18869,35,2021-08-30,9769526,1917,19.62224165225621,815686,19.62224165225621
Hungary,2021,18876,36,2021-09-06,9769526,2626,26.87950264936088,818312,26.87950264936088
Hungary,2021,18883,37,2021-09-13,9769526,3029,31.004574838124185,821341,31.004574838124185
Hungary,2021,18890,38,2021-09-20,9769526,3616,37.01305467634766,824957,37.01305467634766
Hungary,2021,18897,39,2021-09-27,9769526,4581,46.89070892487517,829538,46.89070892487517
Hungary,2021,18904,40,2021-10-04,9769526,6932,70.95533601118417,836470,70.95533601118417
Hungary,2021,18911,41,2021-10-11,9769526,14123,144.56177300720628,850593,144.56177300720628
Hungary,2021,18918,42,2021-10-18,9769526,24117,246.85946892408086,874710,246.85946892408086
Hungary,2021,18925,43,2021-10-25,9769526,35368,362.02370514188715,910078,362.02370514188715
Iceland,2020,18267,0,2020-01-06,364134,0,0,0,0
Iceland,2020,18267,1,2020-01-06,364134,0,0,0,0
Iceland,2020,18274,2,2020-01-13,364134,0,0,0,0
Iceland,2020,18281,3,2020-01-20,364134,0,0,0,0
Iceland,2020,18288,4,2020-01-27,364134,0,0,0,0
Iceland,2020,18295,5,2020-02-03,364134,15,4.11936265221045,15,4.11936265221045
Iceland,2020,18302,6,2020-02-10,364134,0,0,15,0
Iceland,2020,18309,7,2020-02-17,364134,0,0,15,0
Iceland,2020,18316,8,2020-02-24,364134,7,1.92236923769821,22,1.92236923769821
Iceland,2020,18323,9,2020-03-02,364134,53,14.55508137114359,75,14.55508137114359
Iceland,2020,18330,10,2020-03-09,364134,117,32.13102868724151,192,32.13102868724151
Iceland,2020,18337,11,2020-03-16,364134,461,126.60174551126784,653,126.60174551126784
Iceland,2020,18344,12,2020-03-23,364134,509,139.78370599834128,1162,139.78370599834128
Iceland,2020,18351,13,2020-03-30,364134,440,120.8346377981732,1602,120.8346377981732
Iceland,2020,18358,14,2020-04-06,364134,135,37.07426386989405,1737,37.07426386989405
Iceland,2020,18365,15,2020-04-13,364134,53,14.55508137114359,1790,14.55508137114359
Iceland,2020,18372,16,2020-04-20,364134,16,4.39398682902448,1806,4.39398682902448
Iceland,2020,18379,17,2020-04-27,364134,7,1.92236923769821,1813,1.92236923769821
Iceland,2020,18386,18,2020-05-04,364134,2,0.54924835362806,1815,0.54924835362806
Iceland,2020,18393,19,2020-05-11,364134,1,0.27462417681403,1816,0.27462417681403
Iceland,2020,18400,20,2020-05-18,364134,2,0.54924835362806,1818,0.54924835362806
Iceland,2020,18407,21,2020-05-25,364134,2,0.54924835362806,1820,0.54924835362806
Iceland,2020,18414,22,2020-06-01,364134,1,0.27462417681403,1821,0.27462417681403
Iceland,2020,18421,23,2020-06-08,364134,2,0.54924835362806,1823,0.54924835362806
Iceland,2020,18428,24,2020-06-15,364134,5,1.37312088407015,1828,1.37312088407015
Iceland,2020,18435,25,2020-06-22,364134,6,1.64774506088418,1834,1.64774506088418
Iceland,2020,18442,26,2020-06-29,364134,9,2.47161759132627,1843,2.47161759132627
Iceland,2020,18449,27,2020-07-06,364134,3,0.82387253044209,1846,0.82387253044209
Iceland,2020,18456,28,2020-07-13,364134,6,1.64774506088418,1852,1.64774506088418
Iceland,2020,18463,29,2020-07-20,364134,16,4.39398682902448,1868,4.39398682902448
Iceland,2020,18470,30,2020-07-27,364134,59,16.20282643202777,1927,16.20282643202777
Iceland,2020,18477,31,2020-08-03,364134,47,12.90733631025941,1974,12.90733631025941
Iceland,2020,18484,32,2020-08-10,364134,54,14.82970554795762,2028,14.82970554795762
Iceland,2020,18491,33,2020-08-17,364134,55,15.10432972477165,2083,15.10432972477165
Iceland,2020,18498,34,2020-08-24,364134,41,11.25959124937523,2124,11.25959124937523
Iceland,2020,18505,35,2020-08-31,364134,32,8.78797365804896,2156,8.78797365804896
Iceland,2020,18512,36,2020-09-07,364134,25,6.86560442035075,2181,6.86560442035075
Iceland,2020,18519,37,2020-09-14,364134,212,58.22032548457436,2393,58.22032548457436
Iceland,2020,18526,38,2020-09-21,364134,280,76.8947695079284,2673,76.8947695079284
Iceland,2020,18533,39,2020-09-28,364134,321,88.15436075730364,2994,88.15436075730364
Iceland,2020,18540,40,2020-10-05,364134,603,165.5983786188601,3597,165.5983786188601
Iceland,2020,18547,41,2020-10-12,364134,532,146.10006206506395,4129,146.10006206506395
Iceland,2020,18554,42,2020-10-19,364134,397,109.02579819516991,4526,109.02579819516991
Iceland,2020,18561,43,2020-10-26,364134,408,112.04666414012424,4934,112.04666414012424
Iceland,2020,18568,44,2020-11-02,364134,174,47.78460676564122,5108,47.78460676564122
Iceland,2020,18575,45,2020-11-09,364134,108,29.65941109591524,5216,29.65941109591524
Iceland,2020,18582,46,2020-11-16,364134,80,21.9699341451224,5296,21.9699341451224
Iceland,2020,18589,47,2020-11-23,364134,107,29.38478691910121,5403,29.38478691910121
Iceland,2020,18596,48,2020-11-30,364134,105,28.83553856547315,5508,28.83553856547315
Iceland,2020,18603,49,2020-12-07,364134,64,17.57594731609792,5572,17.57594731609792
Iceland,2020,18610,50,2020-12-14,364134,89,24.44155173644867,5661,24.44155173644867
Iceland,2020,18617,51,2020-12-21,364134,82,22.51918249875046,5743,22.51918249875046
Iceland,2020,18624,52,2020-12-28,364134,73,20.04756490742419,5816,20.04756490742419
Iceland,2021,18631,0,2021-01-04,364134,102,28.01166603503106,5918,28.01166603503106
Iceland,2021,18631,1,2021-01-04,364134,70,19.2236923769821,5988,19.2236923769821
Iceland,2021,18638,2,2021-01-11,364134,19,5.21785935946657,6007,5.21785935946657
Iceland,2021,18645,3,2021-01-18,364134,22,6.04173188990866,6029,6.04173188990866
Iceland,2021,18652,4,2021-01-25,364134,12,3.29549012176836,6041,3.29549012176836
Iceland,2021,18659,5,2021-02-01,364134,15,4.11936265221045,6056,4.11936265221045
Iceland,2021,18666,6,2021-02-08,364134,10,2.7462417681403,6066,2.7462417681403
Iceland,2021,18673,7,2021-02-15,364134,10,2.7462417681403,6076,2.7462417681403
Iceland,2021,18680,8,2021-02-22,364134,11,3.02086594495433,6087,3.02086594495433
Iceland,2021,18687,9,2021-03-01,364134,19,5.21785935946657,6106,5.21785935946657
Iceland,2021,18694,10,2021-03-08,364134,38,10.43571871893314,6144,10.43571871893314
Iceland,2021,18701,11,2021-03-15,364134,61,16.75207478565583,6205,16.75207478565583
Iceland,2021,18708,12,2021-03-22,364134,50,13.7312088407015,6255,13.7312088407015
Iceland,2021,18715,13,2021-03-29,364134,34,9.33722201167702,6289,9.33722201167702
Iceland,2021,18722,14,2021-04-05,364134,62,17.02669896246986,6351,17.02669896246986
Iceland,2021,18729,15,2021-04-12,364134,65,17.85057149291195,6416,17.85057149291195
Iceland,2021,18736,16,2021-04-19,364134,54,14.82970554795762,6470,14.82970554795762
Iceland,2021,18743,17,2021-04-26,364134,35,9.61184618849105,6505,9.61184618849105
Iceland,2021,18750,18,2021-05-03,364134,30,8.2387253044209,6535,8.2387253044209
Iceland,2021,18757,19,2021-05-10,364134,7,1.92236923769821,6542,1.92236923769821
Iceland,2021,18764,20,2021-05-17,364134,30,8.2387253044209,6572,8.2387253044209
Iceland,2021,18771,21,2021-05-24,364134,28,7.68947695079284,6600,7.68947695079284
Iceland,2021,18778,22,2021-05-31,364134,11,3.02086594495433,6611,3.02086594495433
Iceland,2021,18785,23,2021-06-07,364134,10,2.7462417681403,6621,2.7462417681403
Iceland,2021,18792,24,2021-06-14,364134,17,4.66861100583851,6638,4.66861100583851
Iceland,2021,18799,25,2021-06-21,364134,16,4.39398682902448,6654,4.39398682902448
Iceland,2021,18806,26,2021-06-28,364134,25,6.86560442035075,6679,6.86560442035075
Iceland,2021,18813,27,2021-07-05,364134,99,27.18779350458897,6778,27.18779350458897
Iceland,2021,18820,28,2021-07-12,364134,519,142.52994776648157,7297,142.52994776648157
Iceland,2021,18827,29,2021-07-19,364134,815,223.81870410343444,8112,223.81870410343444
Iceland,2021,18834,30,2021-07-26,364134,776,213.10836120768727,8888,213.10836120768727
Iceland,2021,18841,31,2021-08-02,364134,680,186.7444402335404,9568,186.7444402335404
Iceland,2021,18848,32,2021-08-09,364134,605,166.14762697248815,10173,166.14762697248815
Iceland,2021,18855,33,2021-08-16,364134,525,144.17769282736575,10698,144.17769282736575
Iceland,2021,18862,34,2021-08-23,364134,355,97.49158276898065,11053,97.49158276898065
Iceland,2021,18869,35,2021-08-30,364134,219,60.14269472227257,11272,60.14269472227257
Iceland,2021,18876,36,2021-09-06,364134,189,51.90396941785167,11461,51.90396941785167
Iceland,2021,18883,37,2021-09-13,364134,251,68.93066838032153,11712,68.93066838032153
Iceland,2021,18890,38,2021-09-20,364134,235,64.53668155129705,11947,64.53668155129705
Iceland,2021,18897,39,2021-09-27,364134,285,78.26789039199855,12232,78.26789039199855
Iceland,2021,18904,40,2021-10-04,364134,373,102.43481795163319,12605,102.43481795163319
Iceland,2021,18911,41,2021-10-11,364134,525,144.17769282736575,13130,144.17769282736575
Iceland,2021,18918,42,2021-10-18,364134,601,165.04913026523204,13731,165.04913026523204
Iceland,2021,18925,43,2021-10-25,364134,827,227.11419422520282,14558,227.11419422520282
Ireland,2020,18267,0,2020-01-06,4964440,0,0,0,0
Ireland,2020,18267,1,2020-01-06,4964440,0,0,0,0
Ireland,2020,18274,2,2020-01-13,4964440,0,0,0,0
Ireland,2020,18281,3,2020-01-20,4964440,0,0,0,0
Ireland,2020,18288,4,2020-01-27,4964440,0,0,0,0
Ireland,2020,18295,5,2020-02-03,4964440,0,0,0,0
Ireland,2020,18302,6,2020-02-10,4964440,0,0,0,0
Ireland,2020,18309,7,2020-02-17,4964440,0,0,0,0
Ireland,2020,18316,8,2020-02-24,4964440,0,0,0,0
Ireland,2020,18323,9,2020-03-02,4964440,18,0.36257865942583656,18,0.36257865942583656
Ireland,2020,18330,10,2020-03-09,4964440,152,3.06177534626262,170,3.06177534626262
Ireland,2020,18337,11,2020-03-16,4964440,781,15.731885167309908,951,15.731885167309908
Ireland,2020,18344,12,2020-03-23,4964440,1689,34.021964209457664,2640,34.021964209457664
Ireland,2020,18351,13,2020-03-30,4964440,2885,58.1133018024188,5525,58.1133018024188
Ireland,2020,18358,14,2020-04-06,4964440,4727,95.21718461699608,10252,95.21718461699608
Ireland,2020,18365,15,2020-04-13,4964440,4971,100.13213977810186,15223,100.13213977810186
Ireland,2020,18372,16,2020-04-20,4964440,3900,78.55870954226458,19123,78.55870954226458
Ireland,2020,18379,17,2020-04-27,4964440,2339,47.11508246650176,21462,47.11508246650176
Ireland,2020,18386,18,2020-05-04,4964440,1453,29.268155119207805,22915,29.268155119207805
Ireland,2020,18393,19,2020-05-11,4964440,1124,22.641022955257792,24039,22.641022955257792
Ireland,2020,18400,20,2020-05-18,4964440,481,9.688907510212632,24520,9.688907510212632
Ireland,2020,18407,21,2020-05-25,4964440,445,8.963750191360958,24965,8.963750191360958
Ireland,2020,18414,22,2020-06-01,4964440,166,3.3437809702604926,25131,3.3437809702604926
Ireland,2020,18421,23,2020-06-08,4964440,119,2.3970478039819194,25250,2.3970478039819194
Ireland,2020,18428,24,2020-06-15,4964440,81,1.6316039674162646,25331,1.6316039674162646
Ireland,2020,18435,25,2020-06-22,4964440,81,1.6316039674162646,25412,1.6316039674162646
Ireland,2020,18442,26,2020-06-29,4964440,72,1.4503146377033462,25484,1.4503146377033462
Ireland,2020,18449,27,2020-07-06,4964440,134,2.699196686836783,25618,2.699196686836783
Ireland,2020,18456,28,2020-07-13,4964440,134,2.699196686836783,25752,2.699196686836783
Ireland,2020,18463,29,2020-07-20,4964440,122,2.4574775805528923,25874,2.4574775805528923
Ireland,2020,18470,30,2020-07-27,4964440,319,6.425699575380103,26193,6.425699575380103
Ireland,2020,18477,31,2020-08-03,4964440,552,11.119078889058988,26745,11.119078889058988
Ireland,2020,18484,32,2020-08-10,4964440,542,10.917646300489078,27287,10.917646300489078
Ireland,2020,18491,33,2020-08-17,4964440,804,16.195180121020698,28091,16.195180121020698
Ireland,2020,18498,34,2020-08-24,4964440,703,14.160710976464616,28794,14.160710976464616
Ireland,2020,18505,35,2020-08-31,4964440,959,19.317385243854293,29753,19.317385243854293
Ireland,2020,18512,36,2020-09-07,4964440,1407,28.341565211786225,31160,28.341565211786225
Ireland,2020,18519,37,2020-09-14,4964440,1926,38.795916558564514,33086,38.795916558564514
Ireland,2020,18526,38,2020-09-21,4964440,2258,45.48347849908549,35344,45.48347849908549
Ireland,2020,18533,39,2020-09-28,4964440,3163,63.713127764662275,38507,63.713127764662275
Ireland,2020,18540,40,2020-10-05,4964440,4756,95.80133912384882,43263,95.80133912384882
Ireland,2020,18547,41,2020-10-12,4964440,7589,152.86719146570408,50852,152.86719146570408
Ireland,2020,18554,42,2020-10-19,4964440,7000,141.00281199893644,57852,141.00281199893644
Ireland,2020,18561,43,2020-10-26,4964440,4653,93.72658346157874,62505,93.72658346157874
Ireland,2020,18568,44,2020-11-02,4964440,2939,59.20103778069631,65444,59.20103778069631
Ireland,2020,18575,45,2020-11-09,4964440,2769,55.776683775007854,68213,55.776683775007854
Ireland,2020,18582,46,2020-11-16,4964440,2379,47.9208128207814,70592,47.9208128207814
Ireland,2020,18589,47,2020-11-23,4964440,1849,37.24488562657621,72441,37.24488562657621
Ireland,2020,18596,48,2020-11-30,4964440,1965,39.581503653987156,74406,39.581503653987156
Ireland,2020,18603,49,2020-12-07,4964440,1984,39.96422557226998,76390,39.96422557226998
Ireland,2020,18610,50,2020-12-14,4964440,3830,77.14868142227522,80220,77.14868142227522
Ireland,2020,18617,51,2020-12-21,4964440,6632,133.59009273956377,86852,133.59009273956377
Ireland,2020,18624,52,2020-12-28,4964440,21058,424.17674501051476,107910,424.17674501051476
Ireland,2021,18631,0,2021-01-04,4964440,44397,894.3002634738258,152307,894.3002634738258
Ireland,2021,18631,1,2021-01-04,4964440,22332,449.8392567943212,174639,449.8392567943212
Ireland,2021,18638,2,2021-01-11,4964440,14060,283.21421952929234,188699,283.21421952929234
Ireland,2021,18645,3,2021-01-18,4964440,8612,173.4737452764058,197311,173.4737452764058
Ireland,2021,18652,4,2021-01-25,4964440,6907,139.12948892523627,204218,139.12948892523627
Ireland,2021,18659,5,2021-02-01,4964440,6015,121.16170202480038,210233,121.16170202480038
Ireland,2021,18666,6,2021-02-08,4964440,5388,108.53187872146708,215621,108.53187872146708
Ireland,2021,18673,7,2021-02-15,4964440,4549,91.63168454045169,220170,91.63168454045169
Ireland,2021,18680,8,2021-02-22,4964440,3377,68.02378516005834,223547,68.02378516005834
Ireland,2021,18687,9,2021-03-01,4964440,3671,73.94590326401367,227218,73.94590326401367
Ireland,2021,18694,10,2021-03-08,4964440,3782,76.18180499713965,231000,76.18180499713965
Ireland,2021,18701,11,2021-03-15,4964440,3996,80.49246239253571,234996,80.49246239253571
Ireland,2021,18708,12,2021-03-22,4964440,3390,68.28564752519922,238386,68.28564752519922
Ireland,2021,18715,13,2021-03-29,4964440,2872,57.85143943727792,241258,57.85143943727792
Ireland,2021,18722,14,2021-04-05,4964440,2594,52.251613475034446,243852,52.251613475034446
Ireland,2021,18729,15,2021-04-12,4964440,3152,63.49155191723538,247004,63.49155191723538
Ireland,2021,18736,16,2021-04-19,4964440,3224,64.94186655493873,250228,64.94186655493873
Ireland,2021,18743,17,2021-04-26,4964440,2912,58.65716979155756,253140,58.65716979155756
Ireland,2021,18750,18,2021-05-03,4964440,3007,60.57077938297169,256147,60.57077938297169
Ireland,2021,18757,19,2021-05-10,4964440,2849,57.38814448356713,258996,57.38814448356713
Ireland,2021,18764,20,2021-05-17,4964440,2807,56.54212761157351,261803,56.54212761157351
Ireland,2021,18771,21,2021-05-24,4964440,2752,55.43424837443901,264555,55.43424837443901
Ireland,2021,18778,22,2021-05-31,4964440,2075,41.79726212825616,266630,41.79726212825616
Ireland,2021,18785,23,2021-06-07,4964440,2033,40.95124525626254,268663,40.95124525626254
Ireland,2021,18792,24,2021-06-14,4964440,2301,46.3496386299361,270964,46.3496386299361
Ireland,2021,18799,25,2021-06-21,4964440,3055,61.53765580810726,274019,61.53765580810726
Ireland,2021,18806,26,2021-06-28,4964440,3666,73.84518696972872,277685,73.84518696972872
Ireland,2021,18813,27,2021-07-05,4964440,6810,137.17559281610815,284495,137.17559281610815
Ireland,2021,18820,28,2021-07-12,4964440,8613,173.49388853526278,293108,173.49388853526278
Ireland,2021,18827,29,2021-07-19,4964440,9081,182.92093368033454,302189,182.92093368033454
Ireland,2021,18834,30,2021-07-26,4964440,10237,206.20654091901605,312426,206.20654091901605
Ireland,2021,18841,31,2021-08-02,4964440,11270,227.01452731828766,323696,227.01452731828766
Ireland,2021,18848,32,2021-08-09,4964440,12720,256.2222526609245,336416,256.2222526609245
Ireland,2021,18855,33,2021-08-16,4964440,11038,222.34129126346576,347454,222.34129126346576
Ireland,2021,18862,34,2021-08-23,4964440,10410,209.69132470127548,357864,209.69132470127548
Ireland,2021,18869,35,2021-08-30,4964440,9599,193.35514176825583,367463,193.35514176825583
Ireland,2021,18876,36,2021-09-06,4964440,8985,180.9871808300634,376448,180.9871808300634
Ireland,2021,18883,37,2021-09-13,4964440,9207,185.4589842963154,385655,185.4589842963154
Ireland,2021,18890,38,2021-09-20,4964440,8801,177.2808212003771,394456,177.2808212003771
Ireland,2021,18897,39,2021-09-27,4964440,9996,201.35201553448124,404452,201.35201553448124
Ireland,2021,18904,40,2021-10-04,4964440,12201,245.7679013141462,416653,245.7679013141462
Ireland,2021,18911,41,2021-10-11,4964440,15014,302.4308884788617,431667,302.4308884788617
Ireland,2021,18918,42,2021-10-18,4964440,16746,337.3190128191699,448413,337.3190128191699
Ireland,2021,18925,43,2021-10-25,4964440,25867,521.0456768537841,474280,521.0456768537841
Isle Of Man,2020,18337,11,2020-03-16,85032,2,2.3520556966788972,2,2.3520556966788972
Isle Of Man,2020,18344,12,2020-03-23,85032,40,47.04111393357795,42,47.04111393357795
Isle Of Man,2020,18351,13,2020-03-30,85032,85,99.96236710885314,127,99.96236710885314
Isle Of Man,2020,18358,14,2020-04-06,85032,23,27.04864051180732,150,27.04864051180732
Isle Of Man,2020,18365,15,2020-04-13,85032,133,156.4117038291467,283,156.4117038291467
Isle Of Man,2020,18372,16,2020-04-20,85032,24,28.22466836014677,307,28.22466836014677
Isle Of Man,2020,18379,17,2020-04-27,85032,2,2.3520556966788972,309,2.3520556966788972
Isle Of Man,2020,18386,18,2020-05-04,85032,17,19.992473421770626,326,19.992473421770626
Isle Of Man,2020,18393,19,2020-05-11,85032,4,4.7041113933577945,330,4.7041113933577945
Isle Of Man,2020,18400,20,2020-05-18,85032,5,5.880139241697243,335,5.880139241697243
Isle Of Man,2020,18407,21,2020-05-25,85032,1,1.1760278483394486,336,1.1760278483394486
Isle Of Man,2020,18414,22,2020-06-01,85032,0,0,336,0
Isle Of Man,2020,18421,23,2020-06-08,85032,0,0,336,0
Isle Of Man,2020,18428,24,2020-06-15,85032,0,0,336,0
Isle Of Man,2020,18435,25,2020-06-22,85032,0,0,336,0
Isle Of Man,2020,18442,26,2020-06-29,85032,0,0,336,0
Isle Of Man,2020,18449,27,2020-07-06,85032,0,0,336,0
Isle Of Man,2020,18456,28,2020-07-13,85032,0,0,336,0
Isle Of Man,2020,18463,29,2020-07-20,85032,0,0,336,0
Isle Of Man,2020,18470,30,2020-07-27,85032,0,0,336,0
Isle Of Man,2020,18477,31,2020-08-03,85032,0,0,336,0
Isle Of Man,2020,18484,32,2020-08-10,85032,0,0,336,0
Isle Of Man,2020,18491,33,2020-08-17,85032,0,0,336,0
Isle Of Man,2020,18498,34,2020-08-24,85032,0,0,336,0
Isle Of Man,2020,18505,35,2020-08-31,85032,0,0,336,0
Isle Of Man,2020,18512,36,2020-09-07,85032,1,1.1760278483394486,337,1.1760278483394486
Isle Of Man,2020,18519,37,2020-09-14,85032,2,2.3520556966788972,339,2.3520556966788972
Isle Of Man,2020,18526,38,2020-09-21,85032,1,1.1760278483394486,340,1.1760278483394486
Isle Of Man,2020,18533,39,2020-09-28,85032,0,0,340,0
Isle Of Man,2020,18540,40,2020-10-05,85032,5,5.880139241697243,345,5.880139241697243
Isle Of Man,2020,18547,41,2020-10-12,85032,1,1.1760278483394486,346,1.1760278483394486
Isle Of Man,2020,18554,42,2020-10-19,85032,2,2.3520556966788972,348,2.3520556966788972
Isle Of Man,2020,18561,43,2020-10-26,85032,4,4.7041113933577945,352,4.7041113933577945
Isle Of Man,2020,18568,44,2020-11-02,85032,3,3.528083545018346,355,3.528083545018346
Isle Of Man,2020,18575,45,2020-11-09,85032,2,2.3520556966788972,357,2.3520556966788972
Isle Of Man,2020,18582,46,2020-11-16,85032,6,7.056167090036692,363,7.056167090036692
Isle Of Man,2020,18589,47,2020-11-23,85032,6,7.056167090036692,369,7.056167090036692
Isle Of Man,2020,18596,48,2020-11-30,85032,0,0,369,0
Isle Of Man,2020,18603,49,2020-12-07,85032,1,1.1760278483394486,370,1.1760278483394486
Isle Of Man,2020,18610,50,2020-12-14,85032,3,3.528083545018346,373,3.528083545018346
Isle Of Man,2020,18617,51,2020-12-21,85032,1,1.1760278483394486,374,1.1760278483394486
Isle Of Man,2020,18624,52,2020-12-28,85032,0,0,374,0
Isle Of Man,2021,18631,0,2021-01-04,85032,6,7.056167090036692,380,7.056167090036692
Isle Of Man,2021,18631,1,2021-01-04,85032,23,27.04864051180732,403,27.04864051180732
Isle Of Man,2021,18638,2,2021-01-11,85032,29,34.10480760184401,432,34.10480760184401
Isle Of Man,2021,18645,3,2021-01-18,85032,0,0,432,0
Isle Of Man,2021,18652,4,2021-01-25,85032,3,3.528083545018346,435,3.528083545018346
Isle Of Man,2021,18659,5,2021-02-01,85032,1,1.1760278483394486,436,1.1760278483394486
Isle Of Man,2021,18666,6,2021-02-08,85032,20,23.520556966788973,456,23.520556966788973
Isle Of Man,2021,18673,7,2021-02-15,85032,30,35.28083545018346,486,35.28083545018346
Isle Of Man,2021,18680,8,2021-02-22,85032,379,445.71455452065106,865,445.71455452065106
Isle Of Man,2021,18687,9,2021-03-01,85032,441,518.6282811176968,1306,518.6282811176968
Isle Of Man,2021,18694,10,2021-03-08,85032,197,231.6774861228714,1503,231.6774861228714
Isle Of Man,2021,18701,11,2021-03-15,85032,63,74.08975444538527,1566,74.08975444538527
Isle Of Man,2021,18708,12,2021-03-22,85032,5,5.880139241697243,1571,5.880139241697243
Isle Of Man,2021,18715,13,2021-03-29,85032,4,4.7041113933577945,1575,4.7041113933577945
Isle Of Man,2021,18722,14,2021-04-05,85032,2,2.3520556966788972,1577,2.3520556966788972
Isle Of Man,2021,18729,15,2021-04-12,85032,10,11.760278483394487,1587,11.760278483394487
Isle Of Man,2021,18736,16,2021-04-19,85032,3,3.528083545018346,1590,3.528083545018346
Isle Of Man,2021,18743,17,2021-04-26,85032,0,0,1590,0
Isle Of Man,2021,18750,18,2021-05-03,85032,1,1.1760278483394486,1591,1.1760278483394486
Isle Of Man,2021,18757,19,2021-05-10,85032,0,0,1591,0
Isle Of Man,2021,18764,20,2021-05-17,85032,2,2.3520556966788972,1593,2.3520556966788972
Isle Of Man,2021,18771,21,2021-05-24,85032,6,7.056167090036692,1599,7.056167090036692
Isle Of Man,2021,18778,22,2021-05-31,85032,1,1.1760278483394486,1600,1.1760278483394486
Isle Of Man,2021,18785,23,2021-06-07,85032,0,0,1600,0
Isle Of Man,2021,18792,24,2021-06-14,85032,11,12.936306331733935,1611,12.936306331733935
Isle Of Man,2021,18799,25,2021-06-21,85032,35,41.1609746918807,1646,41.1609746918807
Isle Of Man,2021,18806,26,2021-06-28,85032,67,78.79386583874306,1713,78.79386583874306
Isle Of Man,2021,18813,27,2021-07-05,85032,837,984.3353090601186,2550,984.3353090601186
Isle Of Man,2021,18820,28,2021-07-12,85032,1644,1933.3897826700536,4194,1933.3897826700536
Isle Of Man,2021,18827,29,2021-07-19,85032,719,845.5640229560636,4913,845.5640229560636
Isle Of Man,2021,18834,30,2021-07-26,85032,674,792.6427697807884,5587,792.6427697807884
Isle Of Man,2021,18841,31,2021-08-02,85032,426,500.98786339260516,6013,500.98786339260516
Isle Of Man,2021,18848,32,2021-08-09,85032,353,415.13783046382537,6366,415.13783046382537
Isle Of Man,2021,18855,33,2021-08-16,85032,286,336.3439646250823,6652,336.3439646250823
Isle Of Man,2021,18862,34,2021-08-23,85032,197,231.6774861228714,6849,231.6774861228714
Isle Of Man,2021,18869,35,2021-08-30,85032,179,210.5089848527613,7028,210.5089848527613
Isle Of Man,2021,18876,36,2021-09-06,85032,156,183.46034434095398,7184,183.46034434095398
Isle Of Man,2021,18883,37,2021-09-13,85032,271,318.7035468999906,7455,318.7035468999906
Isle Of Man,2021,18890,38,2021-09-20,85032,243,285.77476714648606,7698,285.77476714648606
Isle Of Man,2021,18897,39,2021-09-27,85032,423,497.4597798475868,8121,497.4597798475868
Isle Of Man,2021,18904,40,2021-10-04,85032,526,618.59064822655,8647,618.59064822655
Isle Of Man,2021,18911,41,2021-10-11,85032,610,717.3769874870637,9257,717.3769874870637
Isle Of Man,2021,18918,42,2021-10-18,85032,481,565.6693950512748,9738,565.6693950512748
Isle Of Man,2021,18925,43,2021-10-25,85032,232,272.83846081475207,9970,272.83846081475207
Italy,2020,18267,0,2020-01-06,59641488,0,0,0,0
Italy,2020,18267,1,2020-01-06,59641488,0,0,0,0
Italy,2020,18274,2,2020-01-13,59641488,0,0,0,0
Italy,2020,18281,3,2020-01-20,59641488,0,0,0,0
Italy,2020,18288,4,2020-01-27,59641488,2,0.0033533703921002104,2,0.0033533703921002104
Italy,2020,18295,5,2020-02-03,59641488,1,0.0016766851960501052,3,0.0016766851960501052
Italy,2020,18302,6,2020-02-10,59641488,0,0,3,0
Italy,2020,18309,7,2020-02-17,59641488,175,0.29341990930876843,178,0.29341990930876843
Italy,2020,18316,8,2020-02-24,59641488,1977,3.314806632591058,2155,3.314806632591058
Italy,2020,18323,9,2020-03-02,59641488,8263,13.85444977496202,10418,13.85444977496202
Italy,2020,18330,10,2020-03-09,59641488,21104,35.38476437744142,31522,35.38476437744142
Italy,2020,18337,11,2020-03-16,59641488,36624,61.40691862013905,68146,61.40691862013905
Italy,2020,18344,12,2020-03-23,59641488,36862,61.80596969679898,105008,61.80596969679898
Italy,2020,18351,13,2020-03-30,59641488,30960,51.910173669711256,135968,51.910173669711256
Italy,2020,18358,14,2020-04-06,59641488,28195,47.27413910263272,164163,47.27413910263272
Italy,2020,18365,15,2020-04-13,59641488,20733,34.76271416970683,184896,34.76271416970683
Italy,2020,18372,16,2020-04-20,59641488,16926,28.379573628344083,201822,28.379573628344083
Italy,2020,18379,17,2020-04-27,59641488,11430,19.164511790852703,213252,19.164511790852703
Italy,2020,18386,18,2020-05-04,59641488,8272,13.86953994172647,221524,13.86953994172647
Italy,2020,18393,19,2020-05-11,59641488,5273,8.841161038772205,226797,8.841161038772205
Italy,2020,18400,20,2020-05-18,59641488,3860,6.472004856753406,230657,6.472004856753406
Italy,2020,18407,21,2020-05-25,59641488,2855,4.786936234723051,233512,4.786936234723051
Italy,2020,18414,22,2020-06-01,59641488,1855,3.110251038672945,235367,3.110251038672945
Italy,2020,18421,23,2020-06-08,59641488,2163,3.6266700790563777,237530,3.6266700790563777
Italy,2020,18428,24,2020-06-15,59641488,1609,2.6977864804446194,239139,2.6977864804446194
Italy,2020,18435,25,2020-06-22,59641488,1407,2.359096070842498,240546,2.359096070842498
Italy,2020,18442,26,2020-06-29,59641488,1450,2.4311935342726527,241996,2.4311935342726527
Italy,2020,18449,27,2020-07-06,59641488,1438,2.411073311920051,243434,2.411073311920051
Italy,2020,18456,28,2020-07-13,59641488,1479,2.479817404958106,244913,2.479817404958106
Italy,2020,18463,29,2020-07-20,59641488,1731,2.9023420743627324,246644,2.9023420743627324
Italy,2020,18470,30,2020-07-27,59641488,2117,3.549542560038073,248761,3.549542560038073
Italy,2020,18477,31,2020-08-03,59641488,2753,4.615914344725939,251514,4.615914344725939
Italy,2020,18484,32,2020-08-10,59641488,3469,5.816420945097815,254983,5.816420945097815
Italy,2020,18491,33,2020-08-17,59641488,7075,11.862547762054495,262058,11.862547762054495
Italy,2020,18498,34,2020-08-24,59641488,9472,15.881562176986597,271530,15.881562176986597
Italy,2020,18505,35,2020-08-31,59641488,9480,15.894975658554998,281010,15.894975658554998
Italy,2020,18512,36,2020-09-07,59641488,9956,16.693077811874847,290966,16.693077811874847
Italy,2020,18519,37,2020-09-14,59641488,10799,18.106523432145085,301765,18.106523432145085
Italy,2020,18526,38,2020-09-21,59641488,12524,20.99880539533152,314289,20.99880539533152
Italy,2020,18533,39,2020-09-28,59641488,18003,30.185363584490045,332292,30.185363584490045
Italy,2020,18540,40,2020-10-05,59641488,37853,63.46756472608463,370145,63.46756472608463
Italy,2020,18547,41,2020-10-12,59641488,75937,127.32244373245685,446082,127.32244373245685
Italy,2020,18554,42,2020-10-19,59641488,142243,238.49673234175512,588325,238.49673234175512
Italy,2020,18561,43,2020-10-26,59641488,203378,341.0008818022783,791703,341.0008818022783
Italy,2020,18568,44,2020-11-02,59641488,244116,409.3056833189675,1035819,409.3056833189675
Italy,2020,18575,45,2020-11-09,59641488,242952,407.3540217507652,1278771,407.3540217507652
Italy,2020,18582,46,2020-11-16,59641488,214235,359.2046529757943,1493006,359.2046529757943
Italy,2020,18589,47,2020-11-23,59641488,162402,272.2970292089292,1655408,272.2970292089292
Italy,2020,18596,48,2020-11-30,59641488,129959,217.90033139347562,1785367,217.90033139347562
Italy,2020,18603,49,2020-12-07,59641488,108090,181.23290284105587,1893457,181.23290284105587
Italy,2020,18610,50,2020-12-14,59641488,106793,179.0582421417789,2000250,179.0582421417789
Italy,2020,18617,51,2020-12-21,59641488,92425,154.96762924493098,2092675,154.96762924493098
Italy,2020,18624,52,2020-12-28,59641488,116223,194.86938354053137,2208898,194.86938354053137
Italy,2021,18631,0,2021-01-04,59641488,122076,204.68302199301266,2330974,204.68302199301266
Italy,2021,18631,1,2021-01-04,59641488,94023,157.64697218821905,2424997,157.64697218821905
Italy,2021,18638,2,2021-01-11,59641488,85029,142.5668655349444,2510026,142.5668655349444
Italy,2021,18645,3,2021-01-18,59641488,82658,138.5914449351096,2592684,138.5914449351096
Italy,2021,18652,4,2021-01-25,59641488,83332,139.72153075724736,2676016,139.72153075724736
Italy,2021,18659,5,2021-02-01,59641488,83302,139.67123020136586,2759318,139.67123020136586
Italy,2021,18666,6,2021-02-08,59641488,89803,150.5713606608876,2849121,150.5713606608876
Italy,2021,18673,7,2021-02-15,59641488,121512,203.7373715424404,2970633,203.7373715424404
Italy,2021,18680,8,2021-02-22,59641488,142621,239.13051934586207,3113254,239.13051934586207
Italy,2021,18687,9,2021-03-01,59641488,156024,261.6031310285216,3269278,261.6031310285216
Italy,2021,18694,10,2021-03-08,59641488,149351,250.41461071527928,3418629,250.41461071527928
Italy,2021,18701,11,2021-03-15,59641488,144537,242.34304818149405,3563166,242.34304818149405
Italy,2021,18708,12,2021-03-22,59641488,131450,220.40026902078634,3694616,220.40026902078634
Italy,2021,18715,13,2021-03-29,59641488,100744,168.9159733908718,3795360,168.9159733908718
Italy,2021,18722,14,2021-04-05,59641488,97824,164.0200526184055,3893184,164.0200526184055
Italy,2021,18729,15,2021-04-12,59641488,91284,153.0545314362378,3984468,153.0545314362378
Italy,2021,18736,16,2021-04-19,59641488,77956,130.707671143282,4062424,130.707671143282
Italy,2021,18743,17,2021-04-26,59641488,63722,106.8417340627048,4126146,106.8417340627048
Italy,2021,18750,18,2021-05-03,59641488,44367,74.38949209315501,4170513,74.38949209315501
Italy,2021,18757,19,2021-05-10,59641488,30419,51.00308697864815,4200932,51.00308697864815
Italy,2021,18764,20,2021-05-17,59641488,22407,37.569485187894706,4223339,37.569485187894706
Italy,2021,18771,21,2021-05-24,59641488,16264,27.269608028558913,4239603,27.269608028558913
Italy,2021,18778,22,2021-05-31,59641488,11563,19.387510921927365,4251166,19.387510921927365
Italy,2021,18785,23,2021-06-07,59641488,7402,12.410823821162879,4258568,12.410823821162879
Italy,2021,18792,24,2021-06-14,59641488,5262,8.822717501615655,4263830,8.822717501615655
Italy,2021,18799,25,2021-06-21,59641488,5626,9.433030912977893,4269456,9.433030912977893
Italy,2021,18806,26,2021-06-28,59641488,8796,14.748122984456726,4278252,14.748122984456726
Italy,2021,18813,27,2021-07-05,59641488,18846,31.598809204760283,4297098,31.598809204760283
Italy,2021,18820,28,2021-07-12,59641488,31244,52.38635226538949,4328342,52.38635226538949
Italy,2021,18827,29,2021-07-19,59641488,38357,64.31261406489389,4366699,64.31261406489389
Italy,2021,18834,30,2021-07-26,59641488,42530,71.30942138801097,4409229,71.30942138801097
Italy,2021,18841,31,2021-08-02,59641488,43131,72.31710919083709,4452360,72.31710919083709
Italy,2021,18848,32,2021-08-09,59641488,45304,75.96054612185397,4497664,75.96054612185397
Italy,2021,18855,33,2021-08-16,59641488,46026,77.17111283340215,4543690,77.17111283340215
Italy,2021,18862,34,2021-08-23,59641488,39955,66.99195700818196,4583645,66.99195700818196
Italy,2021,18869,35,2021-08-30,59641488,32999,55.328934784457424,4616644,55.328934784457424
Italy,2021,18876,36,2021-09-06,59641488,28879,48.42099177673099,4645523,48.42099177673099
Italy,2021,18883,37,2021-09-13,59641488,23620,39.60330433070349,4669143,39.60330433070349
Italy,2021,18890,38,2021-09-20,59641488,20864,34.98235993038939,4690007,34.98235993038939
Italy,2021,18897,39,2021-09-27,59641488,18043,30.252430992332048,4708050,30.252430992332048
Italy,2021,18904,40,2021-10-04,59641488,17850,29.928830749494377,4725900,29.928830749494377
Italy,2021,18911,41,2021-10-11,59641488,25375,42.54588684977142,4751275,42.54588684977142
Italy,2021,18918,42,2021-10-18,59641488,32130,53.87189534908988,4783405,53.87189534908988
Italy,2021,18925,43,2021-10-25,59641488,38686,64.86424349439437,4822091,64.86424349439437
Jersey,2020,18337,11,2020-03-16,107796,15,13.915173104753423,15,13.915173104753423
Jersey,2020,18344,12,2020-03-23,107796,48,44.52855393521095,63,44.52855393521095
Jersey,2020,18351,13,2020-03-30,107796,92,85.34639504248766,155,85.34639504248766
Jersey,2020,18358,14,2020-04-06,107796,58,53.80533600504657,213,53.80533600504657
Jersey,2020,18365,15,2020-04-13,107796,36,33.39641545140822,249,33.39641545140822
Jersey,2020,18372,16,2020-04-20,107796,32,29.68570262347397,281,29.68570262347397
Jersey,2020,18379,17,2020-04-27,107796,11,10.204460276819177,292,10.204460276819177
Jersey,2020,18386,18,2020-05-04,107796,2,1.855356413967123,294,1.855356413967123
Jersey,2020,18393,19,2020-05-11,107796,8,7.421425655868492,302,7.421425655868492
Jersey,2020,18400,20,2020-05-18,107796,4,3.710712827934246,306,3.710712827934246
Jersey,2020,18407,21,2020-05-25,107796,2,1.855356413967123,308,1.855356413967123
Jersey,2020,18414,22,2020-06-01,107796,3,2.7830346209506844,311,2.7830346209506844
Jersey,2020,18421,23,2020-06-08,107796,2,1.855356413967123,313,1.855356413967123
Jersey,2020,18428,24,2020-06-15,107796,5,4.638391034917808,318,4.638391034917808
Jersey,2020,18435,25,2020-06-22,107796,1,0.9276782069835615,319,0.9276782069835615
Jersey,2020,18442,26,2020-06-29,107796,1,0.9276782069835615,320,0.9276782069835615
Jersey,2020,18449,27,2020-07-06,107796,5,4.638391034917808,325,4.638391034917808
Jersey,2020,18456,28,2020-07-13,107796,6,5.566069241901369,331,5.566069241901369
Jersey,2020,18463,29,2020-07-20,107796,1,0.9276782069835615,332,0.9276782069835615
Jersey,2020,18470,30,2020-07-27,107796,3,2.7830346209506844,335,2.7830346209506844
Jersey,2020,18477,31,2020-08-03,107796,10,9.276782069835615,345,9.276782069835615
Jersey,2020,18484,32,2020-08-10,107796,10,9.276782069835615,355,9.276782069835615
Jersey,2020,18491,33,2020-08-17,107796,8,7.421425655868492,363,7.421425655868492
Jersey,2020,18498,34,2020-08-24,107796,11,10.204460276819177,374,10.204460276819177
Jersey,2020,18505,35,2020-08-31,107796,10,9.276782069835615,384,9.276782069835615
Jersey,2020,18512,36,2020-09-07,107796,-4,-3.710712827934246,380,-3.710712827934246
Jersey,2020,18519,37,2020-09-14,107796,13,12.0598166907863,393,12.0598166907863
Jersey,2020,18526,38,2020-09-21,107796,7,6.493747448884931,400,6.493747448884931
Jersey,2020,18533,39,2020-09-28,107796,21,19.481242346654792,421,19.481242346654792
Jersey,2020,18540,40,2020-10-05,107796,28,25.974989795539724,449,25.974989795539724
Jersey,2020,18547,41,2020-10-12,107796,41,38.034806486326026,490,38.034806486326026
Jersey,2020,18554,42,2020-10-19,107796,40,37.10712827934246,530,37.10712827934246
Jersey,2020,18561,43,2020-10-26,107796,44,40.817841107276706,574,40.817841107276706
Jersey,2020,18568,44,2020-11-02,107796,69,64.00979628186575,643,64.00979628186575
Jersey,2020,18575,45,2020-11-09,107796,89,82.56336042153698,732,82.56336042153698
Jersey,2020,18582,46,2020-11-16,107796,79,73.28657835170137,811,73.28657835170137
Jersey,2020,18589,47,2020-11-23,107796,117,108.5383502170767,928,108.5383502170767
Jersey,2020,18596,48,2020-11-30,107796,429,397.97395079594793,1357,397.97395079594793
Jersey,2020,18603,49,2020-12-07,107796,422,391.48020334706297,1779,391.48020334706297
Jersey,2020,18610,50,2020-12-14,107796,557,516.7167612898438,2336,516.7167612898438
Jersey,2020,18617,51,2020-12-21,107796,327,303.35077368362465,2663,303.35077368362465
Jersey,2020,18624,52,2020-12-28,107796,158,146.57315670340273,2821,146.57315670340273
Jersey,2021,18631,0,2021-01-04,107796,151,140.0794092545178,2972,140.0794092545178
Jersey,2021,18631,1,2021-01-04,107796,82,76.06961297265205,3054,76.06961297265205
Jersey,2021,18638,2,2021-01-11,107796,68,63.08211807488218,3122,63.08211807488218
Jersey,2021,18645,3,2021-01-18,107796,30,27.830346209506846,3152,27.830346209506846
Jersey,2021,18652,4,2021-01-25,107796,24,22.264276967605475,3176,22.264276967605475
Jersey,2021,18659,5,2021-02-01,107796,26,24.1196333815726,3202,24.1196333815726
Jersey,2021,18666,6,2021-02-08,107796,11,10.204460276819177,3213,10.204460276819177
Jersey,2021,18673,7,2021-02-15,107796,4,3.710712827934246,3217,3.710712827934246
Jersey,2021,18680,8,2021-02-22,107796,4,3.710712827934246,3221,3.710712827934246
Jersey,2021,18687,9,2021-03-01,107796,1,0.9276782069835615,3222,0.9276782069835615
Jersey,2021,18694,10,2021-03-08,107796,2,1.855356413967123,3224,1.855356413967123
Jersey,2021,18701,11,2021-03-15,107796,1,0.9276782069835615,3225,0.9276782069835615
Jersey,2021,18708,12,2021-03-22,107796,4,3.710712827934246,3229,3.710712827934246
Jersey,2021,18715,13,2021-03-29,107796,2,1.855356413967123,3231,1.855356413967123
Jersey,2021,18722,14,2021-04-05,107796,2,1.855356413967123,3233,1.855356413967123
Jersey,2021,18729,15,2021-04-12,107796,0,0,3233,0
Jersey,2021,18736,16,2021-04-19,107796,1,0.9276782069835615,3234,0.9276782069835615
Jersey,2021,18743,17,2021-04-26,107796,1,0.9276782069835615,3235,0.9276782069835615
Jersey,2021,18750,18,2021-05-03,107796,1,0.9276782069835615,3236,0.9276782069835615
Jersey,2021,18757,19,2021-05-10,107796,2,1.855356413967123,3238,1.855356413967123
Jersey,2021,18764,20,2021-05-17,107796,5,4.638391034917808,3243,4.638391034917808
Jersey,2021,18771,21,2021-05-24,107796,10,9.276782069835615,3253,9.276782069835615
Jersey,2021,18778,22,2021-05-31,107796,34,31.54105903744109,3287,31.54105903744109
Jersey,2021,18785,23,2021-06-07,107796,26,24.1196333815726,3313,24.1196333815726
Jersey,2021,18792,24,2021-06-14,107796,143,132.6579835986493,3456,132.6579835986493
Jersey,2021,18799,25,2021-06-21,107796,428,397.0462725889643,3884,397.0462725889643
Jersey,2021,18806,26,2021-06-28,107796,921,854.3916286318602,4805,854.3916286318602
Jersey,2021,18813,27,2021-07-05,107796,1758,1630.8582878771012,6563,1630.8582878771012
Jersey,2021,18820,28,2021-07-12,107796,1296,1202.2709562506957,7859,1202.2709562506957
Jersey,2021,18827,29,2021-07-19,107796,401,371.9989610004082,8260,371.9989610004082
Jersey,2021,18834,30,2021-07-26,107796,415,384.98645589817806,8675,384.98645589817806
Jersey,2021,18841,31,2021-08-02,107796,242,224.49812609002188,8917,224.49812609002188
Jersey,2021,18848,32,2021-08-09,107796,230,213.36598760621916,9147,213.36598760621916
Jersey,2021,18855,33,2021-08-16,107796,143,132.6579835986493,9290,132.6579835986493
Jersey,2021,18862,34,2021-08-23,107796,210,194.81242346654793,9500,194.81242346654793
Jersey,2021,18869,35,2021-08-30,107796,182,168.8374336710082,9682,168.8374336710082
Jersey,2021,18876,36,2021-09-06,107796,135,125.2365579427808,9817,125.2365579427808
Jersey,2021,18883,37,2021-09-13,107796,171,158.63297339418904,9988,158.63297339418904
Jersey,2021,18890,38,2021-09-20,107796,72,66.79283090281643,10060,66.79283090281643
Jersey,2021,18897,39,2021-09-27,107796,190,176.2588593268767,10250,176.2588593268767
Jersey,2021,18904,40,2021-10-04,107796,199,184.60796318972874,10449,184.60796318972874
Jersey,2021,18911,41,2021-10-11,107796,289,268.0990018182493,10738,268.0990018182493
Jersey,2021,18918,42,2021-10-18,107796,415,384.98645589817806,11153,384.98645589817806
Jersey,2021,18925,43,2021-10-25,107796,395,366.4328917585068,11548,366.4328917585068
Kosovo,2020,18330,10,2020-03-09,1795666,13,0.723965369951873,13,0.723965369951873
Kosovo,2020,18337,11,2020-03-16,1795666,20,1.1137928768490355,33,1.1137928768490355
Kosovo,2020,18344,12,2020-03-23,1795666,65,3.619826849759365,98,3.619826849759365
Kosovo,2020,18351,13,2020-03-30,1795666,67,3.7312061374442687,165,3.7312061374442687
Kosovo,2020,18358,14,2020-04-06,1795666,197,10.970859836963,362,10.970859836963
Kosovo,2020,18365,15,2020-04-13,1795666,199,11.082239124647902,561,11.082239124647902
Kosovo,2020,18372,16,2020-04-20,1795666,203,11.30499770001771,764,11.30499770001771
Kosovo,2020,18379,17,2020-04-27,1795666,87,4.844999014293304,851,4.844999014293304
Kosovo,2020,18386,18,2020-05-04,1795666,33,1.8377582468009084,884,1.8377582468009084
Kosovo,2020,18393,19,2020-05-11,1795666,101,5.624654028087629,985,5.624654028087629
Kosovo,2020,18400,20,2020-05-18,1795666,47,2.6174132605952334,1032,2.6174132605952334
Kosovo,2020,18407,21,2020-05-25,1795666,51,2.84017183596504,1083,2.84017183596504
Kosovo,2020,18414,22,2020-06-01,1795666,151,8.409136220210216,1234,8.409136220210216
Kosovo,2020,18421,23,2020-06-08,1795666,252,14.033790248297846,1486,14.033790248297846
Kosovo,2020,18428,24,2020-06-15,1795666,683,38.03602674439456,2169,38.03602674439456
Kosovo,2020,18435,25,2020-06-22,1795666,508,28.290339071965498,2677,28.290339071965498
Kosovo,2020,18442,26,2020-06-29,1795666,679,37.81326816902475,3356,37.81326816902475
Kosovo,2020,18449,27,2020-07-06,1795666,1575,87.71118905186154,4931,87.71118905186154
Kosovo,2020,18456,28,2020-07-13,1795666,804,44.77447364933122,5735,44.77447364933122
Kosovo,2020,18463,29,2020-07-20,1795666,1182,65.82515902177799,6917,65.82515902177799
Kosovo,2020,18470,30,2020-07-27,1795666,1882,104.80790971149423,8799,104.80790971149423
Kosovo,2020,18477,31,2020-08-03,1795666,1448,80.63860428387017,10247,80.63860428387017
Kosovo,2020,18484,32,2020-08-10,1795666,1169,65.10119365182612,11416,65.10119365182612
Kosovo,2020,18491,33,2020-08-17,1795666,1032,57.471712445410226,12448,57.471712445410226
Kosovo,2020,18498,34,2020-08-24,1795666,886,49.34102444441227,13334,49.34102444441227
Kosovo,2020,18505,35,2020-08-31,1795666,785,43.71637041632464,14119,43.71637041632464
Kosovo,2020,18512,36,2020-09-07,1795666,518,28.847235510390018,14637,28.847235510390018
Kosovo,2020,18519,37,2020-09-14,1795666,426,23.723788276884456,15063,23.723788276884456
Kosovo,2020,18526,38,2020-09-21,1795666,409,22.777064331562773,15472,22.777064331562773
Kosovo,2020,18533,39,2020-09-28,1795666,342,19.045858194118505,15814,19.045858194118505
Kosovo,2020,18540,40,2020-10-05,1795666,365,20.326720002494895,16179,20.326720002494895
Kosovo,2020,18547,41,2020-10-12,1795666,712,39.65102641582566,16891,39.65102641582566
Kosovo,2020,18554,42,2020-10-19,1795666,1052,58.58550532225926,17943,58.58550532225926
Kosovo,2020,18561,43,2020-10-26,1795666,2236,124.52204363172216,20179,124.52204363172216
Kosovo,2020,18568,44,2020-11-02,1795666,3976,221.42202391758823,24155,221.42202391758823
Kosovo,2020,18575,45,2020-11-09,1795666,4962,276.3320127462457,29117,276.3320127462457
Kosovo,2020,18582,46,2020-11-16,1795666,5178,288.3609758162153,34295,288.3609758162153
Kosovo,2020,18589,47,2020-11-23,1795666,4762,265.1940839777553,39057,265.1940839777553
Kosovo,2020,18596,48,2020-11-30,1795666,3748,208.72478512150923,42805,208.72478512150923
Kosovo,2020,18603,49,2020-12-07,1795666,3775,210.22840550525544,46580,210.22840550525544
Kosovo,2020,18610,50,2020-12-14,1795666,2589,144.18048790810764,49169,144.18048790810764
Kosovo,2020,18617,51,2020-12-21,1795666,1632,90.88549875088128,50801,90.88549875088128
Kosovo,2020,18624,52,2020-12-28,1795666,1164,64.82274543261386,51965,64.82274543261386
Kosovo,2021,18631,0,2021-01-04,1795666,1811,100.85394499868015,53776,100.85394499868015
Kosovo,2021,18631,1,2021-01-04,1795666,2075,115.55601097308742,55851,115.55601097308742
Kosovo,2021,18638,2,2021-01-11,1795666,2237,124.57773327556461,58088,124.57773327556461
Kosovo,2021,18645,3,2021-01-18,1795666,2130,118.61894138442227,60218,118.61894138442227
Kosovo,2021,18652,4,2021-01-25,1795666,2040,113.60687343860161,62258,113.60687343860161
Kosovo,2021,18659,5,2021-02-01,1795666,2083,116.00152812382704,64341,116.00152812382704
Kosovo,2021,18666,6,2021-02-08,1795666,2039,113.55118379475915,66380,113.55118379475915
Kosovo,2021,18673,7,2021-02-15,1795666,2850,158.71548495098753,69230,158.71548495098753
Kosovo,2021,18680,8,2021-02-22,1795666,3818,212.62306019048086,73048,212.62306019048086
Kosovo,2021,18687,9,2021-03-01,1795666,4205,234.17495235750968,77253,234.17495235750968
Kosovo,2021,18694,10,2021-03-08,1795666,4932,274.6613234309721,82185,274.6613234309721
Kosovo,2021,18701,11,2021-03-15,1795666,5796,322.7771757108505,87981,322.7771757108505
Kosovo,2021,18708,12,2021-03-22,1795666,5674,315.98303916207135,93655,315.98303916207135
Kosovo,2021,18715,13,2021-03-29,1795666,4341,241.74874392008314,97996,241.74874392008314
Kosovo,2021,18722,14,2021-04-05,1795666,3521,196.0832359692727,101517,196.0832359692727
Kosovo,2021,18729,15,2021-04-12,1795666,2525,140.61635070219072,104042,140.61635070219072
Kosovo,2021,18736,16,2021-04-19,1795666,1493,83.1446382567805,105535,83.1446382567805
Kosovo,2021,18743,17,2021-04-26,1795666,954,53.127920225698986,106489,53.127920225698986
Kosovo,2021,18750,18,2021-05-03,1795666,354,19.714133920227926,106843,19.714133920227926
Kosovo,2021,18757,19,2021-05-10,1795666,401,22.33154718082316,107244,22.33154718082316
Kosovo,2021,18764,20,2021-05-17,1795666,161,8.966032658634735,107405,8.966032658634735
Kosovo,2021,18771,21,2021-05-24,1795666,102,5.68034367193008,107507,5.68034367193008
Kosovo,2021,18778,22,2021-05-31,1795666,71,3.953964712814076,107578,3.953964712814076
Kosovo,2021,18785,23,2021-06-07,1795666,77,4.288102575868786,107655,4.288102575868786
Kosovo,2021,18792,24,2021-06-14,1795666,84,4.677930082765949,107739,4.677930082765949
Kosovo,2021,18799,25,2021-06-21,1795666,61,3.397068274389558,107800,3.397068274389558
Kosovo,2021,18806,26,2021-06-28,1795666,59,3.2856889867046544,107859,3.2856889867046544
Kosovo,2021,18813,27,2021-07-05,1795666,47,2.6174132605952334,107906,2.6174132605952334
Kosovo,2021,18820,28,2021-07-12,1795666,111,6.181550466512147,108017,6.181550466512147
Kosovo,2021,18827,29,2021-07-19,1795666,496,27.622063345856077,108513,27.622063345856077
Kosovo,2021,18834,30,2021-07-26,1795666,1681,93.61429129916142,110194,93.61429129916142
Kosovo,2021,18841,31,2021-08-02,1795666,6793,378.2997506217749,116987,378.2997506217749
Kosovo,2021,18848,32,2021-08-09,1795666,13389,745.6286414065868,130376,745.6286414065868
Kosovo,2021,18855,33,2021-08-16,1795666,13227,736.6069191041096,143603,736.6069191041096
Kosovo,2021,18862,34,2021-08-23,1795666,9055,504.26972499340076,152658,504.26972499340076
Kosovo,2021,18869,35,2021-08-30,1795666,4603,256.3394306068055,157261,256.3394306068055
Kosovo,2021,18876,36,2021-09-06,1795666,1894,105.47618543760365,159155,105.47618543760365
Kosovo,2021,18883,37,2021-09-13,1795666,738,41.09895715572941,159893,41.09895715572941
Kosovo,2021,18890,38,2021-09-20,1795666,307,17.096720659632695,160200,17.096720659632695
Kosovo,2021,18897,39,2021-09-27,1795666,200,11.137928768490355,160400,11.137928768490355
Kosovo,2021,18904,40,2021-10-04,1795666,141,7.852239781785699,160541,7.852239781785699
Kosovo,2021,18911,41,2021-10-11,1795666,97,5.401895452717822,160638,5.401895452717822
Kosovo,2021,18918,42,2021-10-18,1795666,129,7.183964055676278,160767,7.183964055676278
Kosovo,2021,18925,43,2021-10-25,1795666,113,6.29292975419705,160880,6.29292975419705
Latvia,2020,18267,0,2020-01-06,1907675,0,0,0,0
Latvia,2020,18267,1,2020-01-06,1907675,0,0,0,0
Latvia,2020,18274,2,2020-01-13,1907675,0,0,0,0
Latvia,2020,18281,3,2020-01-20,1907675,0,0,0,0
Latvia,2020,18288,4,2020-01-27,1907675,0,0,0,0
Latvia,2020,18295,5,2020-02-03,1907675,0,0,0,0
Latvia,2020,18302,6,2020-02-10,1907675,0,0,0,0
Latvia,2020,18309,7,2020-02-17,1907675,0,0,0,0
Latvia,2020,18316,8,2020-02-24,1907675,0,0,0,0
Latvia,2020,18323,9,2020-03-02,1907675,3,0.15725949126554575,3,0.15725949126554575
Latvia,2020,18330,10,2020-03-09,1907675,27,1.4153354213899119,30,1.4153354213899119
Latvia,2020,18337,11,2020-03-16,1907675,106,5.55650202471595,136,5.55650202471595
Latvia,2020,18344,12,2020-03-23,1907675,211,11.060584219010051,347,11.060584219010051
Latvia,2020,18351,13,2020-03-30,1907675,187,9.802508288885685,534,9.802508288885685
Latvia,2020,18358,14,2020-04-06,1907675,118,6.185539989778133,652,6.185539989778133
Latvia,2020,18365,15,2020-04-13,1907675,76,3.9839071120604923,728,3.9839071120604923
Latvia,2020,18372,16,2020-04-20,1907675,85,4.45568558585713,813,4.45568558585713
Latvia,2020,18379,17,2020-04-27,1907675,67,3.5121286382638552,880,3.5121286382638552
Latvia,2020,18386,18,2020-05-04,1907675,60,3.145189825310915,940,3.145189825310915
Latvia,2020,18393,19,2020-05-11,1907675,68,3.564548468685704,1008,3.564548468685704
Latvia,2020,18400,20,2020-05-18,1907675,39,2.044373386452095,1047,2.044373386452095
Latvia,2020,18407,21,2020-05-25,1907675,19,0.9959767780151231,1066,0.9959767780151231
Latvia,2020,18414,22,2020-06-01,1907675,22,1.1532362692806688,1088,1.1532362692806688
Latvia,2020,18421,23,2020-06-08,1907675,9,0.4717784737966373,1097,0.4717784737966373
Latvia,2020,18428,24,2020-06-15,1907675,14,0.7338776259058802,1111,0.7338776259058802
Latvia,2020,18435,25,2020-06-22,1907675,5,0.26209915210924295,1116,0.26209915210924295
Latvia,2020,18442,26,2020-06-29,1907675,8,0.4193586433747887,1124,0.4193586433747887
Latvia,2020,18449,27,2020-07-06,1907675,49,2.5685716906705807,1173,2.5685716906705807
Latvia,2020,18456,28,2020-07-13,1907675,19,0.9959767780151231,1192,0.9959767780151231
Latvia,2020,18463,29,2020-07-20,1907675,27,1.4153354213899119,1219,1.4153354213899119
Latvia,2020,18470,30,2020-07-27,1907675,24,1.258075930124366,1243,1.258075930124366
Latvia,2020,18477,31,2020-08-03,1907675,47,2.4637320298268834,1290,2.4637320298268834
Latvia,2020,18484,32,2020-08-10,1907675,32,1.6774345734991547,1322,1.6774345734991547
Latvia,2020,18491,33,2020-08-17,1907675,15,0.7862974563277287,1337,0.7862974563277287
Latvia,2020,18498,34,2020-08-24,1907675,56,2.935510503623521,1393,2.935510503623521
Latvia,2020,18505,35,2020-08-31,1907675,35,1.8346940647647005,1428,1.8346940647647005
Latvia,2020,18512,36,2020-09-07,1907675,46,2.411312199405035,1474,2.411312199405035
Latvia,2020,18519,37,2020-09-14,1907675,51,2.673411351514278,1525,2.673411351514278
Latvia,2020,18526,38,2020-09-21,1907675,151,7.9153943936991364,1676,7.9153943936991364
Latvia,2020,18533,39,2020-09-28,1907675,410,21.49213047295792,2086,21.49213047295792
Latvia,2020,18540,40,2020-10-05,1907675,584,30.613180966359575,2670,30.613180966359575
Latvia,2020,18547,41,2020-10-12,1907675,780,40.887467729041894,3450,40.887467729041894
Latvia,2020,18554,42,2020-10-19,1907675,1228,64.37155175803007,4678,64.37155175803007
Latvia,2020,18561,43,2020-10-26,1907675,1458,76.42811275505524,6136,76.42811275505524
Latvia,2020,18568,44,2020-11-02,1907675,1959,102.69044779640137,8095,102.69044779640137
Latvia,2020,18575,45,2020-11-09,1907675,2452,128.53342419437274,10547,128.53342419437274
Latvia,2020,18582,46,2020-11-16,1907675,2573,134.8762236754164,13120,134.8762236754164
Latvia,2020,18589,47,2020-11-23,1907675,3855,202.0784462762263,16975,202.0784462762263
Latvia,2020,18596,48,2020-11-30,1907675,4338,227.39722436997917,21313,227.39722436997917
Latvia,2020,18603,49,2020-12-07,1907675,4362,228.65530030010353,25675,228.65530030010353
Latvia,2020,18610,50,2020-12-14,1907675,5265,275.9904071710328,30940,275.9904071710328
Latvia,2020,18617,51,2020-12-21,1907675,5390,282.5428859737639,36330,282.5428859737639
Latvia,2020,18624,52,2020-12-28,1907675,6167,323.27309421154024,42497,323.27309421154024
Latvia,2021,18631,0,2021-01-04,1907675,7071,370.6606209128914,49568,370.6606209128914
Latvia,2021,18631,1,2021-01-04,1907675,6096,319.551286251589,55664,319.551286251589
Latvia,2021,18638,2,2021-01-11,1907675,5342,280.02673411351515,61006,280.02673411351515
Latvia,2021,18645,3,2021-01-18,1907675,5233,274.31297259753364,66239,274.31297259753364
Latvia,2021,18652,4,2021-01-25,1907675,5559,291.4018373150563,71798,291.4018373150563
Latvia,2021,18659,5,2021-02-01,1907675,4906,257.17168804958914,76704,257.17168804958914
Latvia,2021,18666,6,2021-02-08,1907675,4813,252.29664382035725,81517,252.29664382035725
Latvia,2021,18673,7,2021-02-15,1907675,4667,244.64334857876736,86184,244.64334857876736
Latvia,2021,18680,8,2021-02-22,1907675,4145,217.28019709856238,90329,217.28019709856238
Latvia,2021,18687,9,2021-03-01,1907675,3450,180.84841495537762,93779,180.84841495537762
Latvia,2021,18694,10,2021-03-08,1907675,3628,190.17914477046668,97407,190.17914477046668
Latvia,2021,18701,11,2021-03-15,1907675,3631,190.3364042617322,101038,190.3364042617322
Latvia,2021,18708,12,2021-03-22,1907675,3065,160.66678024296593,104103,160.66678024296593
Latvia,2021,18715,13,2021-03-29,1907675,3503,183.6266659677356,107606,183.6266659677356
Latvia,2021,18722,14,2021-04-05,1907675,3726,195.31628815180784,111332,195.31628815180784
Latvia,2021,18729,15,2021-04-12,1907675,3982,208.73576473980106,115314,208.73576473980106
Latvia,2021,18736,16,2021-04-19,1907675,4434,232.42952809047662,119748,232.42952809047662
Latvia,2021,18743,17,2021-04-26,1907675,4213,220.84474556724808,123961,220.84474556724808
Latvia,2021,18750,18,2021-05-03,1907675,4015,210.46561914372208,127976,210.46561914372208
Latvia,2021,18757,19,2021-05-10,1907675,2967,155.52963686162477,130943,155.52963686162477
Latvia,2021,18764,20,2021-05-17,1907675,2153,112.85989489824,133096,112.85989489824
Latvia,2021,18771,21,2021-05-24,1907675,1714,89.84758934304847,134810,89.84758934304847
Latvia,2021,18778,22,2021-05-31,1907675,1218,63.84735345381158,136028,63.84735345381158
Latvia,2021,18785,23,2021-06-07,1907675,780,40.887467729041894,136808,40.887467729041894
Latvia,2021,18792,24,2021-06-14,1907675,400,20.967932168739434,137208,20.967932168739434
Latvia,2021,18799,25,2021-06-21,1907675,421,22.068748607598256,137629,22.068748607598256
Latvia,2021,18806,26,2021-06-28,1907675,268,14.048514553055421,137897,14.048514553055421
Latvia,2021,18813,27,2021-07-05,1907675,260,13.629155909680632,138157,13.629155909680632
Latvia,2021,18820,28,2021-07-12,1907675,322,16.879185395835243,138479,16.879185395835243
Latvia,2021,18827,29,2021-07-19,1907675,418,21.91148911633271,138897,21.91148911633271
Latvia,2021,18834,30,2021-07-26,1907675,522,27.363151480204962,139419,27.363151480204962
Latvia,2021,18841,31,2021-08-02,1907675,701,36.74630112571586,140120,36.74630112571586
Latvia,2021,18848,32,2021-08-09,1907675,923,48.38350347936625,141043,48.38350347936625
Latvia,2021,18855,33,2021-08-16,1907675,1274,66.7828639574351,142317,66.7828639574351
Latvia,2021,18862,34,2021-08-23,1907675,2199,115.27120709764503,144516,115.27120709764503
Latvia,2021,18869,35,2021-08-30,1907675,2675,140.22304637844496,147191,140.22304637844496
Latvia,2021,18876,36,2021-09-06,1907675,3367,176.4975690303642,150558,176.4975690303642
Latvia,2021,18883,37,2021-09-13,1907675,4226,221.52620336273213,154784,221.52620336273213
Latvia,2021,18890,38,2021-09-20,1907675,6855,359.3379375417721,161639,359.3379375417721
Latvia,2021,18897,39,2021-09-27,1907675,9635,505.0650661145111,171274,505.0650661145111
Latvia,2021,18904,40,2021-10-04,1907675,14340,751.7003682493087,185614,751.7003682493087
Latvia,2021,18911,41,2021-10-11,1907675,16957,888.8830644632865,202571,888.8830644632865
Latvia,2021,18918,42,2021-10-18,1907675,16566,868.3869107683437,219137,868.3869107683437
Latvia,2021,18925,43,2021-10-25,1907675,12685,664.9455489011493,231822,664.9455489011493
Liechtenstein,2020,18267,0,2020-01-06,38747,0,0,0,0
Liechtenstein,2020,18267,1,2020-01-06,38747,0,0,0,0
Liechtenstein,2020,18274,2,2020-01-13,38747,0,0,0,0
Liechtenstein,2020,18281,3,2020-01-20,38747,0,0,0,0
Liechtenstein,2020,18288,4,2020-01-27,38747,0,0,0,0
Liechtenstein,2020,18295,5,2020-02-03,38747,0,0,0,0
Liechtenstein,2020,18302,6,2020-02-10,38747,0,0,0,0
Liechtenstein,2020,18309,7,2020-02-17,38747,0,0,0,0
Liechtenstein,2020,18316,8,2020-02-24,38747,0,0,0,0
Liechtenstein,2020,18323,9,2020-03-02,38747,2,5.161689937285467,2,5.161689937285467
Liechtenstein,2020,18330,10,2020-03-09,38747,11,28.38929465507007,13,28.38929465507007
Liechtenstein,2020,18337,11,2020-03-16,38747,35,90.32957390249568,48,90.32957390249568
Liechtenstein,2020,18344,12,2020-03-23,38747,17,43.87436446692647,65,43.87436446692647
Liechtenstein,2020,18351,13,2020-03-30,38747,13,33.55098459235554,78,33.55098459235554
Liechtenstein,2020,18358,14,2020-04-06,38747,3,7.742534905928201,81,7.742534905928201
Liechtenstein,2020,18365,15,2020-04-13,38747,1,2.5808449686427335,82,2.5808449686427335
Liechtenstein,2020,18372,16,2020-04-20,38747,0,0,82,0
Liechtenstein,2020,18379,17,2020-04-27,38747,0,0,82,0
Liechtenstein,2020,18386,18,2020-05-04,38747,0,0,82,0
Liechtenstein,2020,18393,19,2020-05-11,38747,0,0,82,0
Liechtenstein,2020,18400,20,2020-05-18,38747,0,0,82,0
Liechtenstein,2020,18407,21,2020-05-25,38747,0,0,82,0
Liechtenstein,2020,18414,22,2020-06-01,38747,0,0,82,0
Liechtenstein,2020,18421,23,2020-06-08,38747,0,0,82,0
Liechtenstein,2020,18428,24,2020-06-15,38747,0,0,82,0
Liechtenstein,2020,18435,25,2020-06-22,38747,0,0,82,0
Liechtenstein,2020,18442,26,2020-06-29,38747,2,5.161689937285467,84,5.161689937285467
Liechtenstein,2020,18449,27,2020-07-06,38747,0,0,84,0
Liechtenstein,2020,18456,28,2020-07-13,38747,2,5.161689937285467,86,5.161689937285467
Liechtenstein,2020,18463,29,2020-07-20,38747,0,0,86,0
Liechtenstein,2020,18470,30,2020-07-27,38747,2,5.161689937285467,88,5.161689937285467
Liechtenstein,2020,18477,31,2020-08-03,38747,0,0,88,0
Liechtenstein,2020,18484,32,2020-08-10,38747,8,20.646759749141868,96,20.646759749141868
Liechtenstein,2020,18491,33,2020-08-17,38747,4,10.323379874570934,100,10.323379874570934
Liechtenstein,2020,18498,34,2020-08-24,38747,7,18.065914780499135,107,18.065914780499135
Liechtenstein,2020,18505,35,2020-08-31,38747,0,0,107,0
Liechtenstein,2020,18512,36,2020-09-07,38747,4,10.323379874570934,111,10.323379874570934
Liechtenstein,2020,18519,37,2020-09-14,38747,2,5.161689937285467,113,5.161689937285467
Liechtenstein,2020,18526,38,2020-09-21,38747,4,10.323379874570934,117,10.323379874570934
Liechtenstein,2020,18533,39,2020-09-28,38747,10,25.808449686427338,127,25.808449686427338
Liechtenstein,2020,18540,40,2020-10-05,38747,21,54.197744341497405,148,54.197744341497405
Liechtenstein,2020,18547,41,2020-10-12,38747,76,196.14421761684775,224,196.14421761684775
Liechtenstein,2020,18554,42,2020-10-19,38747,177,456.80955944976387,401,456.80955944976387
Liechtenstein,2020,18561,43,2020-10-26,38747,196,505.8456138539758,597,505.8456138539758
Liechtenstein,2020,18568,44,2020-11-02,38747,199,513.588148759904,796,513.588148759904
Liechtenstein,2020,18575,45,2020-11-09,38747,186,480.03716416754844,982,480.03716416754844
Liechtenstein,2020,18582,46,2020-11-16,38747,166,428.42026479469376,1148,428.42026479469376
Liechtenstein,2020,18589,47,2020-11-23,38747,118,304.5397062998426,1266,304.5397062998426
Liechtenstein,2020,18596,48,2020-11-30,38747,127,327.76731101762715,1393,327.76731101762715
Liechtenstein,2020,18603,49,2020-12-07,38747,170,438.7436446692647,1563,438.7436446692647
Liechtenstein,2020,18610,50,2020-12-14,38747,216,557.4625132268304,1779,557.4625132268304
Liechtenstein,2020,18617,51,2020-12-21,38747,256,660.6963119725398,2035,660.6963119725398
Liechtenstein,2020,18624,52,2020-12-28,38747,186,480.03716416754844,2221,480.03716416754844
Liechtenstein,2021,18631,0,2021-01-04,38747,122,314.8630861744135,2343,314.8630861744135
Liechtenstein,2021,18631,1,2021-01-04,38747,50,129.0422484321367,2393,129.0422484321367
Liechtenstein,2021,18638,2,2021-01-11,38747,63,162.5932330244922,2456,162.5932330244922
Liechtenstein,2021,18645,3,2021-01-18,38747,43,110.97633365163755,2499,110.97633365163755
Liechtenstein,2021,18652,4,2021-01-25,38747,29,74.84450409063928,2528,74.84450409063928
Liechtenstein,2021,18659,5,2021-02-01,38747,14,36.13182956099827,2542,36.13182956099827
Liechtenstein,2021,18666,6,2021-02-08,38747,11,28.38929465507007,2553,28.38929465507007
Liechtenstein,2021,18673,7,2021-02-15,38747,26,67.10196918471108,2579,67.10196918471108
Liechtenstein,2021,18680,8,2021-02-22,38747,16,41.293519498283736,2595,41.293519498283736
Liechtenstein,2021,18687,9,2021-03-01,38747,20,51.616899372854675,2615,51.616899372854675
Liechtenstein,2021,18694,10,2021-03-08,38747,20,51.616899372854675,2635,51.616899372854675
Liechtenstein,2021,18701,11,2021-03-15,38747,32,82.58703899656747,2667,82.58703899656747
Liechtenstein,2021,18708,12,2021-03-22,38747,33,85.16788396521021,2700,85.16788396521021
Liechtenstein,2021,18715,13,2021-03-29,38747,57,147.10816321263582,2757,147.10816321263582
Liechtenstein,2021,18722,14,2021-04-05,38747,69,178.07830283634863,2826,178.07830283634863
Liechtenstein,2021,18729,15,2021-04-12,38747,62,160.0123880558495,2888,160.0123880558495
Liechtenstein,2021,18736,16,2021-04-19,38747,61,157.43154308720676,2949,157.43154308720676
Liechtenstein,2021,18743,17,2021-04-26,38747,28,72.26365912199654,2977,72.26365912199654
Liechtenstein,2021,18750,18,2021-05-03,38747,16,41.293519498283736,2993,41.293519498283736
Liechtenstein,2021,18757,19,2021-05-10,38747,10,25.808449686427338,3003,25.808449686427338
Liechtenstein,2021,18764,20,2021-05-17,38747,13,33.55098459235554,3016,33.55098459235554
Liechtenstein,2021,18771,21,2021-05-24,38747,9,23.2276047177846,3025,23.2276047177846
Liechtenstein,2021,18778,22,2021-05-31,38747,3,7.742534905928201,3028,7.742534905928201
Liechtenstein,2021,18785,23,2021-06-07,38747,3,7.742534905928201,3031,7.742534905928201
Liechtenstein,2021,18792,24,2021-06-14,38747,6,15.485069811856402,3037,15.485069811856402
Liechtenstein,2021,18799,25,2021-06-21,38747,11,28.38929465507007,3048,28.38929465507007
Liechtenstein,2021,18806,26,2021-06-28,38747,11,28.38929465507007,3059,28.38929465507007
Liechtenstein,2021,18813,27,2021-07-05,38747,12,30.970139623712804,3071,30.970139623712804
Liechtenstein,2021,18820,28,2021-07-12,38747,7,18.065914780499135,3078,18.065914780499135
Liechtenstein,2021,18827,29,2021-07-19,38747,9,23.2276047177846,3087,23.2276047177846
Liechtenstein,2021,18834,30,2021-07-26,38747,14,36.13182956099827,3101,36.13182956099827
Liechtenstein,2021,18841,31,2021-08-02,38747,60,154.85069811856403,3161,154.85069811856403
Liechtenstein,2021,18848,32,2021-08-09,38747,67,172.91661289906315,3228,172.91661289906315
Liechtenstein,2021,18855,33,2021-08-16,38747,37,95.49126383978114,3265,95.49126383978114
Liechtenstein,2021,18862,34,2021-08-23,38747,66,170.33576793042042,3331,170.33576793042042
Liechtenstein,2021,18869,35,2021-08-30,38747,56,144.52731824399308,3387,144.52731824399308
Liechtenstein,2021,18876,36,2021-09-06,38747,32,82.58703899656747,3419,82.58703899656747
Liechtenstein,2021,18883,37,2021-09-13,38747,27,69.6828141533538,3446,69.6828141533538
Liechtenstein,2021,18890,38,2021-09-20,38747,5,12.904224843213669,3451,12.904224843213669
Liechtenstein,2021,18897,39,2021-09-27,38747,12,30.970139623712804,3463,30.970139623712804
Liechtenstein,2021,18904,40,2021-10-04,38747,35,90.32957390249568,3498,90.32957390249568
Liechtenstein,2021,18911,41,2021-10-11,38747,41,105.81464371435207,3539,105.81464371435207
Liechtenstein,2021,18918,42,2021-10-18,38747,40,103.23379874570935,3579,103.23379874570935
Liechtenstein,2021,18925,43,2021-10-25,38747,95,245.1802720210597,3674,245.1802720210597
Lithuania,2020,18267,0,2020-01-06,2794090,0,0,0,0
Lithuania,2020,18267,1,2020-01-06,2794090,0,0,0,0
Lithuania,2020,18274,2,2020-01-13,2794090,0,0,0,0
Lithuania,2020,18281,3,2020-01-20,2794090,0,0,0,0
Lithuania,2020,18288,4,2020-01-27,2794090,0,0,0,0
Lithuania,2020,18295,5,2020-02-03,2794090,0,0,0,0
Lithuania,2020,18302,6,2020-02-10,2794090,0,0,0,0
Lithuania,2020,18309,7,2020-02-17,2794090,0,0,0,0
Lithuania,2020,18316,8,2020-02-24,2794090,0,0,0,0
Lithuania,2020,18323,9,2020-03-02,2794090,0,0,0,0
Lithuania,2020,18330,10,2020-03-09,2794090,0,0,0,0
Lithuania,2020,18337,11,2020-03-16,2794090,0,0,0,0
Lithuania,2020,18344,12,2020-03-23,2794090,0,0,0,0
Lithuania,2020,18351,13,2020-03-30,2794090,0,0,0,0
Lithuania,2020,18358,14,2020-04-06,2794090,0,0,0,0
Lithuania,2020,18365,15,2020-04-13,2794090,0,0,0,0
Lithuania,2020,18372,16,2020-04-20,2794090,155,5.547423311346449,155,5.547423311346449
Lithuania,2020,18379,17,2020-04-27,2794090,79,2.827396397395932,234,2.827396397395932
Lithuania,2020,18386,18,2020-05-04,2794090,72,2.5768676026899633,306,2.5768676026899633
Lithuania,2020,18393,19,2020-05-11,2794090,72,2.5768676026899633,378,2.5768676026899633
Lithuania,2020,18400,20,2020-05-18,2794090,77,2.7558167417656554,455,2.7558167417656554
Lithuania,2020,18407,21,2020-05-25,2794090,43,1.5389625960509503,498,1.5389625960509503
Lithuania,2020,18414,22,2020-06-01,2794090,45,1.6105422516812271,543,1.6105422516812271
Lithuania,2020,18421,23,2020-06-08,2794090,52,1.8610710463871958,595,1.8610710463871958
Lithuania,2020,18428,24,2020-06-15,2794090,28,1.0021151788238747,623,1.0021151788238747
Lithuania,2020,18435,25,2020-06-22,2794090,15,0.5368474172270757,638,0.5368474172270757
Lithuania,2020,18442,26,2020-06-29,2794090,25,0.8947456953784595,663,0.8947456953784595
Lithuania,2020,18449,27,2020-07-06,2794090,33,1.1810643178995666,696,1.1810643178995666
Lithuania,2020,18456,28,2020-07-13,2794090,73,2.612657430505102,769,2.612657430505102
Lithuania,2020,18463,29,2020-07-20,2794090,72,2.5768676026899633,841,2.5768676026899633
Lithuania,2020,18470,30,2020-07-27,2794090,100,3.578982781513838,941,3.578982781513838
Lithuania,2020,18477,31,2020-08-03,2794090,145,5.189525033195065,1086,5.189525033195065
Lithuania,2020,18484,32,2020-08-10,2794090,172,6.155850384203801,1258,6.155850384203801
Lithuania,2020,18491,33,2020-08-17,2794090,236,8.446399364372658,1494,8.446399364372658
Lithuania,2020,18498,34,2020-08-24,2794090,233,8.339029880927242,1727,8.339029880927242
Lithuania,2020,18505,35,2020-08-31,2794090,193,6.907436768321707,1920,6.907436768321707
Lithuania,2020,18512,36,2020-09-07,2794090,286,10.235890755129578,2206,10.235890755129578
Lithuania,2020,18519,37,2020-09-14,2794090,428,15.318046304879227,2634,15.318046304879227
Lithuania,2020,18526,38,2020-09-21,2794090,676,24.193923603033546,3310,24.193923603033546
Lithuania,2020,18533,39,2020-09-28,2794090,793,28.381333457404736,4103,28.381333457404736
Lithuania,2020,18540,40,2020-10-05,2794090,960,34.35823470253285,5063,34.35823470253285
Lithuania,2020,18547,41,2020-10-12,2794090,1478,52.89736551077453,6541,52.89736551077453
Lithuania,2020,18554,42,2020-10-19,2794090,3229,115.56535401508184,9770,115.56535401508184
Lithuania,2020,18561,43,2020-10-26,2794090,5590,200.06513748662354,15360,200.06513748662354
Lithuania,2020,18568,44,2020-11-02,2794090,9143,327.22639571381023,24503,327.22639571381023
Lithuania,2020,18575,45,2020-11-09,2794090,10206,365.2709826813023,34709,365.2709826813023
Lithuania,2020,18582,46,2020-11-16,2794090,12323,441.0380481659503,47032,441.0380481659503
Lithuania,2020,18589,47,2020-11-23,2794090,13115,469.38359179553987,60147,469.38359179553987
Lithuania,2020,18596,48,2020-11-30,2794090,14691,525.7883604321979,74838,525.7883604321979
Lithuania,2020,18603,49,2020-12-07,2794090,18977,679.1835624478811,93815,679.1835624478811
Lithuania,2020,18610,50,2020-12-14,2794090,19481,697.2216356667108,113296,697.2216356667108
Lithuania,2020,18617,51,2020-12-21,2794090,17880,639.9221213346742,131176,639.9221213346742
Lithuania,2020,18624,52,2020-12-28,2794090,15632,559.4665884062432,146808,559.4665884062432
Lithuania,2021,18631,0,2021-01-04,2794090,12460,445.94125457662426,159268,445.94125457662426
Lithuania,2021,18631,1,2021-01-04,2794090,7554,270.3563593155553,166822,270.3563593155553
Lithuania,2021,18638,2,2021-01-11,2794090,6404,229.1980573281462,173226,229.1980573281462
Lithuania,2021,18645,3,2021-01-18,2794090,5438,194.62508365872253,178664,194.62508365872253
Lithuania,2021,18652,4,2021-01-25,2794090,3956,141.58455883668745,182620,141.58455883668745
Lithuania,2021,18659,5,2021-02-01,2794090,3238,115.88746246541808,185858,115.88746246541808
Lithuania,2021,18666,6,2021-02-08,2794090,3252,116.38852005483001,189110,116.38852005483001
Lithuania,2021,18673,7,2021-02-15,2794090,3479,124.51281096886643,192589,124.51281096886643
Lithuania,2021,18680,8,2021-02-22,2794090,2911,104.18418876986783,195500,104.18418876986783
Lithuania,2021,18687,9,2021-03-01,2794090,3079,110.19687984281107,198579,110.19687984281107
Lithuania,2021,18694,10,2021-03-08,2794090,3469,124.15491269071505,202048,124.15491269071505
Lithuania,2021,18701,11,2021-03-15,2794090,4652,166.49427899602375,206700,166.49427899602375
Lithuania,2021,18708,12,2021-03-22,2794090,5600,200.42303576477494,212300,200.42303576477494
Lithuania,2021,18715,13,2021-03-29,2794090,6278,224.68853902343875,218578,224.68853902343875
Lithuania,2021,18722,14,2021-04-05,2794090,7014,251.0298522953806,225592,251.0298522953806
Lithuania,2021,18729,15,2021-04-12,2794090,7262,259.90572959353494,232854,259.90572959353494
Lithuania,2021,18736,16,2021-04-19,2794090,6216,222.4695696989002,239070,222.4695696989002
Lithuania,2021,18743,17,2021-04-26,2794090,9330,333.9190935152411,248400,333.9190935152411
Lithuania,2021,18750,18,2021-05-03,2794090,7083,253.49935041462516,255483,253.49935041462516
Lithuania,2021,18757,19,2021-05-10,2794090,4839,173.18697679745463,260322,173.18697679745463
Lithuania,2021,18764,20,2021-05-17,2794090,3094,110.73372726003815,263416,110.73372726003815
Lithuania,2021,18771,21,2021-05-24,2794090,2042,73.08282839851258,265458,73.08282839851258
Lithuania,2021,18778,22,2021-05-31,2794090,1190,42.58989510001467,266648,42.58989510001467
Lithuania,2021,18785,23,2021-06-07,2794090,554,19.827564609586663,267202,19.827564609586663
Lithuania,2021,18792,24,2021-06-14,2794090,256,9.162195920675426,267458,9.162195920675426
Lithuania,2021,18799,25,2021-06-21,2794090,200,7.157965563027676,267658,7.157965563027676
Lithuania,2021,18806,26,2021-06-28,2794090,306,10.951687311432345,267964,10.951687311432345
Lithuania,2021,18813,27,2021-07-05,2794090,556,19.89914426521694,268520,19.89914426521694
Lithuania,2021,18820,28,2021-07-12,2794090,1210,43.30569165631744,269730,43.30569165631744
Lithuania,2021,18827,29,2021-07-19,2794090,2108,75.44495703431171,271838,75.44495703431171
Lithuania,2021,18834,30,2021-07-26,2794090,3089,110.55477812096245,274927,110.55477812096245
Lithuania,2021,18841,31,2021-08-02,2794090,3606,129.058119101389,278533,129.058119101389
Lithuania,2021,18848,32,2021-08-09,2794090,3981,142.4793045320659,282514,142.4793045320659
Lithuania,2021,18855,33,2021-08-16,2794090,4041,144.62669420097419,286555,144.62669420097419
Lithuania,2021,18862,34,2021-08-23,2794090,4770,170.71747867821009,291325,170.71747867821009
Lithuania,2021,18869,35,2021-08-30,2794090,5883,210.5515570364591,297208,210.5515570364591
Lithuania,2021,18876,36,2021-09-06,2794090,7697,275.47430469312013,304905,275.47430469312013
Lithuania,2021,18883,37,2021-09-13,2794090,9166,328.0495617535584,314071,328.0495617535584
Lithuania,2021,18890,38,2021-09-20,2794090,11891,425.57684254981046,325962,425.57684254981046
Lithuania,2021,18897,39,2021-09-27,2794090,14573,521.5651607500116,340535,521.5651607500116
Lithuania,2021,18904,40,2021-10-04,2794090,16233,580.9762749231413,356768,580.9762749231413
Lithuania,2021,18911,41,2021-10-11,2794090,20656,739.2746833494984,377424,739.2746833494984
Lithuania,2021,18918,42,2021-10-18,2794090,21069,754.0558822371505,398493,754.0558822371505
Lithuania,2021,18925,43,2021-10-25,2794090,18096,647.6527241427442,416589,647.6527241427442
Luxembourg,2020,18267,0,2020-01-06,626108,0,0,0,0
Luxembourg,2020,18267,1,2020-01-06,626108,0,0,0,0
Luxembourg,2020,18274,2,2020-01-13,626108,0,0,0,0
Luxembourg,2020,18281,3,2020-01-20,626108,0,0,0,0
Luxembourg,2020,18288,4,2020-01-27,626108,0,0,0,0
Luxembourg,2020,18295,5,2020-02-03,626108,0,0,0,0
Luxembourg,2020,18302,6,2020-02-10,626108,0,0,0,0
Luxembourg,2020,18309,7,2020-02-17,626108,0,0,0,0
Luxembourg,2020,18316,8,2020-02-24,626108,1,0.15971685396129742,1,0.15971685396129742
Luxembourg,2020,18323,9,2020-03-02,626108,3,0.4791505618838922,4,0.4791505618838922
Luxembourg,2020,18330,10,2020-03-09,626108,83,13.256498878787685,87,13.256498878787685
Luxembourg,2020,18337,11,2020-03-16,626108,682,108.92689440160484,769,108.92689440160484
Luxembourg,2020,18344,12,2020-03-23,626108,1070,170.89703373858822,1839,170.89703373858822
Luxembourg,2020,18351,13,2020-03-30,626108,627,100.14246743373347,2466,100.14246743373347
Luxembourg,2020,18358,14,2020-04-06,626108,298,47.59562248046663,2764,47.59562248046663
Luxembourg,2020,18365,15,2020-04-13,626108,178,28.429600005110938,2942,28.429600005110938
Luxembourg,2020,18372,16,2020-04-20,626108,95,15.173101126323255,3037,15.173101126323255
Luxembourg,2020,18379,17,2020-04-27,626108,62,9.90244494560044,3099,9.90244494560044
Luxembourg,2020,18386,18,2020-05-04,626108,37,5.909523596568004,3136,5.909523596568004
Luxembourg,2020,18393,19,2020-05-11,626108,37,5.909523596568004,3173,5.909523596568004
Luxembourg,2020,18400,20,2020-05-18,626108,37,5.909523596568004,3210,5.909523596568004
Luxembourg,2020,18407,21,2020-05-25,626108,16,2.5554696633807588,3226,2.5554696633807588
Luxembourg,2020,18414,22,2020-06-01,626108,13,2.0763191014968663,3239,2.0763191014968663
Luxembourg,2020,18421,23,2020-06-08,626108,25,3.9929213490324353,3264,3.9929213490324353
Luxembourg,2020,18428,24,2020-06-15,626108,41,6.548391012413194,3305,6.548391012413194
Luxembourg,2020,18435,25,2020-06-22,626108,127,20.28404045308477,3432,20.28404045308477
Luxembourg,2020,18442,26,2020-06-29,626108,250,39.92921349032435,3682,39.92921349032435
Luxembourg,2020,18449,27,2020-07-06,626108,343,54.78288090872501,4025,54.78288090872501
Luxembourg,2020,18456,28,2020-07-13,626108,570,91.03860675793952,4595,91.03860675793952
Luxembourg,2020,18463,29,2020-07-20,626108,580,92.6357752975525,5175,92.6357752975525
Luxembourg,2020,18470,30,2020-07-27,626108,439,70.11569888900956,5614,70.11569888900956
Luxembourg,2020,18477,31,2020-08-03,626108,300,47.91505618838922,5914,47.91505618838922
Luxembourg,2020,18484,32,2020-08-10,626108,202,32.26280450018208,6116,32.26280450018208
Luxembourg,2020,18491,33,2020-08-17,626108,279,44.56100225520198,6395,44.56100225520198
Luxembourg,2020,18498,34,2020-08-24,626108,301,48.07477304235052,6696,48.07477304235052
Luxembourg,2020,18505,35,2020-08-31,626108,293,46.79703821066014,6989,46.79703821066014
Luxembourg,2020,18512,36,2020-09-07,626108,285,45.51930337896976,7274,45.51930337896976
Luxembourg,2020,18519,37,2020-09-14,626108,671,107.17000900803056,7945,107.17000900803056
Luxembourg,2020,18526,38,2020-09-21,626108,465,74.26833709200329,8410,74.26833709200329
Luxembourg,2020,18533,39,2020-09-28,626108,553,88.32342024059747,8963,88.32342024059747
Luxembourg,2020,18540,40,2020-10-05,626108,811,129.5303685626122,9774,129.5303685626122
Luxembourg,2020,18547,41,2020-10-12,626108,1295,206.83332587988014,11069,206.83332587988014
Luxembourg,2020,18554,42,2020-10-19,626108,3351,535.2111776243077,14420,535.2111776243077
Luxembourg,2020,18561,43,2020-10-26,626108,4679,747.3151596849106,19099,747.3151596849106
Luxembourg,2020,18568,44,2020-11-02,626108,4107,655.9571192190484,23206,655.9571192190484
Luxembourg,2020,18575,45,2020-11-09,626108,3813,609.0003641544271,27019,609.0003641544271
Luxembourg,2020,18582,46,2020-11-16,626108,3858,616.1876225826854,30877,616.1876225826854
Luxembourg,2020,18589,47,2020-11-23,626108,3565,569.3905843720253,34442,569.3905843720253
Luxembourg,2020,18596,48,2020-11-30,626108,3810,608.5212135925432,38252,608.5212135925432
Luxembourg,2020,18603,49,2020-12-07,626108,3426,547.1899416714049,41678,547.1899416714049
Luxembourg,2020,18610,50,2020-12-14,626108,2701,431.39522254946434,44379,431.39522254946434
Luxembourg,2020,18617,51,2020-12-21,626108,1303,208.11106071157053,45682,208.11106071157053
Luxembourg,2020,18624,52,2020-12-28,626108,1159,185.1118337411437,46841,185.1118337411437
Luxembourg,2021,18631,0,2021-01-04,626108,1046,167.0638292435171,47887,167.0638292435171
Luxembourg,2021,18631,1,2021-01-04,626108,867,138.47451238444486,48754,138.47451238444486
Luxembourg,2021,18638,2,2021-01-11,626108,848,135.4398921591802,49602,135.4398921591802
Luxembourg,2021,18645,3,2021-01-18,626108,1020,162.91119104052336,50622,162.91119104052336
Luxembourg,2021,18652,4,2021-01-25,626108,1132,180.79947868418867,51754,180.79947868418867
Luxembourg,2021,18659,5,2021-02-01,626108,1077,172.01505171631732,52831,172.01505171631732
Luxembourg,2021,18666,6,2021-02-08,626108,1254,200.28493486746694,54085,200.28493486746694
Luxembourg,2021,18673,7,2021-02-15,626108,1310,209.2290786892996,55395,209.2290786892996
Luxembourg,2021,18680,8,2021-02-22,626108,1189,189.90333935998262,56584,189.90333935998262
Luxembourg,2021,18687,9,2021-03-01,626108,1249,199.48635059766048,57833,199.48635059766048
Luxembourg,2021,18694,10,2021-03-08,626108,1584,252.9914966746951,59417,252.9914966746951
Luxembourg,2021,18701,11,2021-03-15,626108,1701,271.6783685881669,61118,271.6783685881669
Luxembourg,2021,18708,12,2021-03-22,626108,1554,248.19999105585617,62672,248.19999105585617
Luxembourg,2021,18715,13,2021-03-29,626108,1302,207.95134385760923,63974,207.95134385760923
Luxembourg,2021,18722,14,2021-04-05,626108,1280,204.4375730704607,65254,204.4375730704607
Luxembourg,2021,18729,15,2021-04-12,626108,1213,193.73654385505375,66467,193.73654385505375
Luxembourg,2021,18736,16,2021-04-19,626108,1099,175.52882250346585,67566,175.52882250346585
Luxembourg,2021,18743,17,2021-04-26,626108,923,147.41865620627752,68489,147.41865620627752
Luxembourg,2021,18750,18,2021-05-03,626108,735,117.3918876615536,69224,117.3918876615536
Luxembourg,2021,18757,19,2021-05-10,626108,503,80.3375775425326,69727,80.3375775425326
Luxembourg,2021,18764,20,2021-05-17,626108,358,57.178633718144475,70085,57.178633718144475
Luxembourg,2021,18771,21,2021-05-24,626108,323,51.588543829499066,70408,51.588543829499066
Luxembourg,2021,18778,22,2021-05-31,626108,199,31.783653938298183,70607,31.783653938298183
Luxembourg,2021,18785,23,2021-06-07,626108,99,15.811968542168444,70706,15.811968542168444
Luxembourg,2021,18792,24,2021-06-14,626108,122,19.485456183278284,70828,19.485456183278284
Luxembourg,2021,18799,25,2021-06-21,626108,818,130.64838654034128,71646,130.64838654034128
Luxembourg,2021,18806,26,2021-06-28,626108,881,140.71054833990303,72527,140.71054833990303
Luxembourg,2021,18813,27,2021-07-05,626108,760,121.38480901058604,73287,121.38480901058604
Luxembourg,2021,18820,28,2021-07-12,626108,618,98.7050157480818,73905,98.7050157480818
Luxembourg,2021,18827,29,2021-07-19,626108,485,77.46267417122924,74390,77.46267417122924
Luxembourg,2021,18834,30,2021-07-26,626108,469,74.90720450784849,74859,74.90720450784849
Luxembourg,2021,18841,31,2021-08-02,626108,344,54.94259776268631,75203,54.94259776268631
Luxembourg,2021,18848,32,2021-08-09,626108,487,77.78210787915184,75690,77.78210787915184
Luxembourg,2021,18855,33,2021-08-16,626108,598,95.51067866885585,76288,95.51067866885585
Luxembourg,2021,18862,34,2021-08-23,626108,603,96.30926293866234,76891,96.30926293866234
Luxembourg,2021,18869,35,2021-08-30,626108,585,93.43435956735898,77476,93.43435956735898
Luxembourg,2021,18876,36,2021-09-06,626108,568,90.71917305001693,78044,90.71917305001693
Luxembourg,2021,18883,37,2021-09-13,626108,614,98.06614833223661,78658,98.06614833223661
Luxembourg,2021,18890,38,2021-09-20,626108,609,97.26756406243013,79267,97.26756406243013
Luxembourg,2021,18897,39,2021-09-27,626108,834,133.20385620372204,80101,133.20385620372204
Luxembourg,2021,18904,40,2021-10-04,626108,961,153.4878966568068,81062,153.4878966568068
Luxembourg,2021,18911,41,2021-10-11,626108,1172,187.18815284264056,82234,187.18815284264056
Luxembourg,2021,18918,42,2021-10-18,626108,1290,206.03474161007367,83524,206.03474161007367
Luxembourg,2021,18925,43,2021-10-25,626108,1398,223.28416183789378,84922,223.28416183789378
Macedonia,2020,18267,0,2020-01-06,2076255,0,0,0,0
Macedonia,2020,18267,1,2020-01-06,2076255,0,0,0,0
Macedonia,2020,18274,2,2020-01-13,2076255,0,0,0,0
Macedonia,2020,18281,3,2020-01-20,2076255,0,0,0,0
Macedonia,2020,18288,4,2020-01-27,2076255,0,0,0,0
Macedonia,2020,18295,5,2020-02-03,2076255,0,0,0,0
Macedonia,2020,18302,6,2020-02-10,2076255,0,0,0,0
Macedonia,2020,18309,7,2020-02-17,2076255,0,0,0,0
Macedonia,2020,18316,8,2020-02-24,2076255,1,0.04816364078593429,1,0.04816364078593429
Macedonia,2020,18323,9,2020-03-02,2076255,2,0.09632728157186858,3,0.09632728157186858
Macedonia,2020,18330,10,2020-03-09,2076255,10,0.4816364078593429,13,0.4816364078593429
Macedonia,2020,18337,11,2020-03-16,2076255,101,4.864527719379363,114,4.864527719379363
Macedonia,2020,18344,12,2020-03-23,2076255,145,6.983727913960472,259,6.983727913960472
Macedonia,2020,18351,13,2020-03-30,2076255,224,10.788655536049282,483,10.788655536049282
Macedonia,2020,18358,14,2020-04-06,2076255,345,16.61645607114733,828,16.61645607114733
Macedonia,2020,18365,15,2020-04-13,2076255,379,18.254019857869096,1207,18.254019857869096
Macedonia,2020,18372,16,2020-04-20,2076255,179,8.621291700682239,1386,8.621291700682239
Macedonia,2020,18379,17,2020-04-27,2076255,125,6.020455098241786,1511,6.020455098241786
Macedonia,2020,18386,18,2020-05-04,2076255,131,6.309436942957392,1642,6.309436942957392
Macedonia,2020,18393,19,2020-05-11,2076255,150,7.224546117890143,1792,7.224546117890143
Macedonia,2020,18400,20,2020-05-18,2076255,186,8.958437186183778,1978,8.958437186183778
Macedonia,2020,18407,21,2020-05-25,2076255,248,11.944582914911704,2226,11.944582914911704
Macedonia,2020,18414,22,2020-06-01,2076255,802,38.627239910319304,3028,38.627239910319304
Macedonia,2020,18421,23,2020-06-08,2076255,1029,49.560386368726384,4057,49.560386368726384
Macedonia,2020,18428,24,2020-06-15,2076255,1049,50.52365918444507,5106,50.52365918444507
Macedonia,2020,18435,25,2020-06-22,2076255,986,47.48934981493121,6092,47.48934981493121
Macedonia,2020,18442,26,2020-06-29,2076255,954,45.94811330978131,7046,45.94811330978131
Macedonia,2020,18449,27,2020-07-06,2076255,1065,51.29427743702002,8111,51.29427743702002
Macedonia,2020,18456,28,2020-07-13,2076255,1021,49.17507724243891,9132,49.17507724243891
Macedonia,2020,18463,29,2020-07-20,2076255,954,45.94811330978131,10086,45.94811330978131
Macedonia,2020,18470,30,2020-07-27,2076255,968,46.622404280784394,11054,46.622404280784394
Macedonia,2020,18477,31,2020-08-03,2076255,802,38.627239910319304,11856,38.627239910319304
Macedonia,2020,18484,32,2020-08-10,2076255,883,42.528494813979975,12739,42.528494813979975
Macedonia,2020,18491,33,2020-08-17,2076255,775,37.32682160909908,13514,37.32682160909908
Macedonia,2020,18498,34,2020-08-24,2076255,413,19.891583644590863,13927,19.891583644590863
Macedonia,2020,18505,35,2020-08-31,2076255,835,40.21664005625513,14762,40.21664005625513
Macedonia,2020,18512,36,2020-09-07,2076255,932,44.88851321249076,15694,44.88851321249076
Macedonia,2020,18519,37,2020-09-14,2076255,1041,50.1383500581576,16735,50.1383500581576
Macedonia,2020,18526,38,2020-09-21,2076255,894,43.05829486262525,17629,43.05829486262525
Macedonia,2020,18533,39,2020-09-28,2076255,973,46.863222484714065,18602,46.863222484714065
Macedonia,2020,18540,40,2020-10-05,2076255,2335,112.46210123515657,20937,112.46210123515657
Macedonia,2020,18547,41,2020-10-12,2076255,2691,129.60835735494916,23628,129.60835735494916
Macedonia,2020,18554,42,2020-10-19,2076255,3326,160.19226925401745,26954,160.19226925401745
Macedonia,2020,18561,43,2020-10-26,2076255,5482,264.03307878849176,32436,264.03307878849176
Macedonia,2020,18568,44,2020-11-02,2076255,7324,352.75050511618275,39760,352.75050511618275
Macedonia,2020,18575,45,2020-11-09,2076255,7290,351.11294132946097,47050,351.11294132946097
Macedonia,2020,18582,46,2020-11-16,2076255,7693,370.5228885661925,54743,370.5228885661925
Macedonia,2020,18589,47,2020-11-23,2076255,6800,327.5127573443532,61543,327.5127573443532
Macedonia,2020,18596,48,2020-11-30,2076255,6425,309.4513920496278,67968,309.4513920496278
Macedonia,2020,18603,49,2020-12-07,2076255,5670,273.0878432562474,73638,273.0878432562474
Macedonia,2020,18610,50,2020-12-14,2076255,4667,224.77971154795534,78305,224.77971154795534
Macedonia,2020,18617,51,2020-12-21,2076255,3499,168.52457910998407,81804,168.52457910998407
Macedonia,2020,18624,52,2020-12-28,2076255,2220,106.92328254477412,84024,106.92328254477412
Macedonia,2021,18631,0,2021-01-04,2076255,2470,118.96419274125769,86494,118.96419274125769
Macedonia,2021,18631,1,2021-01-04,2076255,2444,117.7119380808234,88938,117.7119380808234
Macedonia,2021,18638,2,2021-01-11,2076255,1716,82.64880758866325,90654,82.64880758866325
Macedonia,2021,18645,3,2021-01-18,2076255,2039,98.20566356252002,92693,98.20566356252002
Macedonia,2021,18652,4,2021-01-25,2076255,2105,101.38446385439168,94798,101.38446385439168
Macedonia,2021,18659,5,2021-02-01,2076255,2254,108.5608463314959,97052,108.5608463314959
Macedonia,2021,18666,6,2021-02-08,2076255,2233,107.54940987499127,99285,107.54940987499127
Macedonia,2021,18673,7,2021-02-15,2076255,3502,168.6690700323419,102787,168.6690700323419
Macedonia,2021,18680,8,2021-02-22,2076255,4376,210.76409207924846,107163,210.76409207924846
Macedonia,2021,18687,9,2021-03-01,2076255,5483,264.0812424292777,112646,264.0812424292777
Macedonia,2021,18694,10,2021-03-08,2076255,6732,324.2376297709096,119378,324.2376297709096
Macedonia,2021,18701,11,2021-03-15,2076255,7560,364.1171243416632,126938,364.1171243416632
Macedonia,2021,18708,12,2021-03-22,2076255,7196,346.58555909558316,134134,346.58555909558316
Macedonia,2021,18715,13,2021-03-29,2076255,7710,371.34167045955337,141844,371.34167045955337
Macedonia,2021,18722,14,2021-04-05,2076255,5250,252.85911412615502,147094,252.85911412615502
Macedonia,2021,18729,15,2021-04-12,2076255,3494,168.2837609060544,150588,168.2837609060544
Macedonia,2021,18736,16,2021-04-19,2076255,2097,100.9991547281042,152685,100.9991547281042
Macedonia,2021,18743,17,2021-04-26,2076255,1341,64.58744229393788,154026,64.58744229393788
Macedonia,2021,18750,18,2021-05-03,2076255,672,32.36596660814784,154698,32.36596660814784
Macedonia,2021,18757,19,2021-05-10,2076255,365,17.579728886866015,155063,17.579728886866015
Macedonia,2021,18764,20,2021-05-17,2076255,209,10.066200924260267,155272,10.066200924260267
Macedonia,2021,18771,21,2021-05-24,2076255,146,7.031891554746406,155418,7.031891554746406
Macedonia,2021,18778,22,2021-05-31,2076255,118,5.6833096127402465,155536,5.6833096127402465
Macedonia,2021,18785,23,2021-06-07,2076255,88,4.2384003891622175,155624,4.2384003891622175
Macedonia,2021,18792,24,2021-06-14,2076255,49,2.36001839851078,155673,2.36001839851078
Macedonia,2021,18799,25,2021-06-21,2076255,43,2.0710365537951745,155716,2.0710365537951745
Macedonia,2021,18806,26,2021-06-28,2076255,86,4.142073107590349,155802,4.142073107590349
Macedonia,2021,18813,27,2021-07-05,2076255,129,6.2131096613855235,155931,6.2131096613855235
Macedonia,2021,18820,28,2021-07-12,2076255,155,7.465364321819815,156086,7.465364321819815
Macedonia,2021,18827,29,2021-07-19,2076255,366,17.62789252765195,156452,17.62789252765195
Macedonia,2021,18834,30,2021-07-26,2076255,1573,75.76140695627464,158025,75.76140695627464
Macedonia,2021,18841,31,2021-08-02,2076255,4139,199.34930921298204,162164,199.34930921298204
Macedonia,2021,18848,32,2021-08-09,2076255,6708,323.08170239204725,168872,323.08170239204725
Macedonia,2021,18855,33,2021-08-16,2076255,6458,311.04079219556365,175330,311.04079219556365
Macedonia,2021,18862,34,2021-08-23,2076255,4715,227.09156630568017,180045,227.09156630568017
Macedonia,2021,18869,35,2021-08-30,2076255,3478,167.51314265347946,183523,167.51314265347946
Macedonia,2021,18876,36,2021-09-06,2076255,3391,163.32290590510317,186914,163.32290590510317
Macedonia,2021,18883,37,2021-09-13,2076255,2973,143.19050405658265,189887,143.19050405658265
Macedonia,2021,18890,38,2021-09-20,2076255,2591,124.79199327635574,192478,124.79199327635574
Macedonia,2021,18897,39,2021-09-27,2076255,2413,116.21886521645945,194891,116.21886521645945
Macedonia,2021,18904,40,2021-10-04,2076255,2200,105.96000972905544,197091,105.96000972905544
Macedonia,2021,18911,41,2021-10-11,2076255,2675,128.83773910237423,199766,128.83773910237423
Macedonia,2021,18918,42,2021-10-18,2076255,2786,134.18390322961292,202552,134.18390322961292
Macedonia,2021,18925,43,2021-10-25,2076255,3525,169.77683377041836,206077,169.77683377041836
Malta,2020,18267,0,2020-01-06,514564,0,0,0,0
Malta,2020,18267,1,2020-01-06,514564,0,0,0,0
Malta,2020,18274,2,2020-01-13,514564,0,0,0,0
Malta,2020,18281,3,2020-01-20,514564,0,0,0,0
Malta,2020,18288,4,2020-01-27,514564,0,0,0,0
Malta,2020,18295,5,2020-02-03,514564,0,0,0,0
Malta,2020,18302,6,2020-02-10,514564,0,0,0,0
Malta,2020,18309,7,2020-02-17,514564,0,0,0,0
Malta,2020,18316,8,2020-02-24,514564,0,0,0,0
Malta,2020,18323,9,2020-03-02,514564,3,0.5830178558935332,3,0.5830178558935332
Malta,2020,18330,10,2020-03-09,514564,27,5.247160703041798,30,5.247160703041798
Malta,2020,18337,11,2020-03-16,514564,77,14.964124967934017,107,14.964124967934017
Malta,2020,18344,12,2020-03-23,514564,49,9.522624979594376,156,9.522624979594376
Malta,2020,18351,13,2020-03-30,514564,79,15.352803538529706,235,15.352803538529706
Malta,2020,18358,14,2020-04-06,514564,149,28.956553509378814,384,28.956553509378814
Malta,2020,18365,15,2020-04-13,514564,44,8.550928553105154,428,8.550928553105154
Malta,2020,18372,16,2020-04-20,514564,20,3.8867857059568878,448,3.8867857059568878
Malta,2020,18379,17,2020-04-27,514564,30,5.830178558935332,478,5.830178558935332
Malta,2020,18386,18,2020-05-04,514564,23,4.469803561850421,501,4.469803561850421
Malta,2020,18393,19,2020-05-11,514564,54,10.494321406083596,555,10.494321406083596
Malta,2020,18400,20,2020-05-18,514564,56,10.882999976679287,611,10.882999976679287
Malta,2020,18407,21,2020-05-25,514564,7,1.3603749970849108,618,1.3603749970849108
Malta,2020,18414,22,2020-06-01,514564,11,2.1377321382762884,629,2.1377321382762884
Malta,2020,18421,23,2020-06-08,514564,21,4.0811249912547325,650,4.0811249912547325
Malta,2020,18428,24,2020-06-15,514564,15,2.915089279467666,665,2.915089279467666
Malta,2020,18435,25,2020-06-22,514564,5,0.9716964264892219,670,0.9716964264892219
Malta,2020,18442,26,2020-06-29,514564,2,0.3886785705956888,672,0.3886785705956888
Malta,2020,18449,27,2020-07-06,514564,2,0.3886785705956888,674,0.3886785705956888
Malta,2020,18456,28,2020-07-13,514564,3,0.5830178558935332,677,0.5830178558935332
Malta,2020,18463,29,2020-07-20,514564,24,4.664142847148265,701,4.664142847148265
Malta,2020,18470,30,2020-07-27,514564,167,32.45466064474001,868,32.45466064474001
Malta,2020,18477,31,2020-08-03,514564,243,47.224446327376185,1111,47.224446327376185
Malta,2020,18484,32,2020-08-10,514564,368,71.51685698960674,1479,71.51685698960674
Malta,2020,18491,33,2020-08-17,514564,295,57.33008916286409,1774,57.33008916286409
Malta,2020,18498,34,2020-08-24,514564,249,48.39048203916325,2023,48.39048203916325
Malta,2020,18505,35,2020-08-31,514564,233,45.281053474397744,2256,45.281053474397744
Malta,2020,18512,36,2020-09-07,514564,326,63.35460700709727,2582,63.35460700709727
Malta,2020,18519,37,2020-09-14,514564,376,73.07157127198948,2958,73.07157127198948
Malta,2020,18526,38,2020-09-21,514564,230,44.69803561850421,3188,44.69803561850421
Malta,2020,18533,39,2020-09-28,514564,320,62.188571295310204,3508,62.188571295310204
Malta,2020,18540,40,2020-10-05,514564,519,100.86208906958123,4027,100.86208906958123
Malta,2020,18547,41,2020-10-12,514564,891,173.15630320037934,4918,173.15630320037934
Malta,2020,18554,42,2020-10-19,514564,841,163.43933893548714,5759,163.43933893548714
Malta,2020,18561,43,2020-10-26,514564,801,155.66576752357335,6560,155.66576752357335
Malta,2020,18568,44,2020-11-02,514564,801,155.66576752357335,7361,155.66576752357335
Malta,2020,18575,45,2020-11-09,514564,772,150.02992824993586,8133,150.02992824993586
Malta,2020,18582,46,2020-11-16,514564,847,164.6053746472742,8980,164.6053746472742
Malta,2020,18589,47,2020-11-23,514564,867,168.49216035323107,9847,168.49216035323107
Malta,2020,18596,48,2020-11-30,514564,783,152.16766038821217,10630,152.16766038821217
Malta,2020,18603,49,2020-12-07,514564,589,114.46583904043034,11219,114.46583904043034
Malta,2020,18610,50,2020-12-14,514564,546,106.10924977262303,11765,106.10924977262303
Malta,2020,18617,51,2020-12-21,514564,624,121.2677140258549,12389,121.2677140258549
Malta,2020,18624,52,2020-12-28,514564,801,155.66576752357335,13190,155.66576752357335
Malta,2021,18631,0,2021-01-04,514564,1299,252.44673160189987,14489,252.44673160189987
Malta,2021,18631,1,2021-01-04,514564,1204,233.98449949860463,15693,233.98449949860463
Malta,2021,18638,2,2021-01-11,514564,924,179.5694996152082,16617,179.5694996152082
Malta,2021,18645,3,2021-01-18,514564,1058,205.61096384511936,17675,205.61096384511936
Malta,2021,18652,4,2021-01-25,514564,687,133.5110889996191,18362,133.5110889996191
Malta,2021,18659,5,2021-02-01,514564,1130,219.60339238656417,19492,219.60339238656417
Malta,2021,18666,6,2021-02-08,514564,1133,220.1864102424577,20625,220.1864102424577
Malta,2021,18673,7,2021-02-15,514564,1554,302.00324935285016,22179,302.00324935285016
Malta,2021,18680,8,2021-02-22,514564,1904,370.0219992070957,24083,370.0219992070957
Malta,2021,18687,9,2021-03-01,514564,2029,394.31440986932625,26112,394.31440986932625
Malta,2021,18694,10,2021-03-08,514564,1745,339.12205284473845,27857,339.12205284473845
Malta,2021,18701,11,2021-03-15,514564,613,119.12998188757861,28470,119.12998188757861
Malta,2021,18708,12,2021-03-22,514564,337,65.49233914537356,28807,65.49233914537356
Malta,2021,18715,13,2021-03-29,514564,436,84.73192838986016,29243,84.73192838986016
Malta,2021,18722,14,2021-04-05,514564,360,69.96214270722398,29603,69.96214270722398
Malta,2021,18729,15,2021-04-12,514564,157,30.51126779176157,29760,30.51126779176157
Malta,2021,18736,16,2021-04-19,514564,164,31.87164278884648,29924,31.87164278884648
Malta,2021,18743,17,2021-04-26,514564,105,20.405624956273662,30029,20.405624956273662
Malta,2021,18750,18,2021-05-03,514564,29,5.635839273637488,30058,5.635839273637488
Malta,2021,18757,19,2021-05-10,514564,22,4.275464276552577,30080,4.275464276552577
Malta,2021,18764,20,2021-05-17,514564,29,5.635839273637488,30109,5.635839273637488
Malta,2021,18771,21,2021-05-24,514564,35,6.801874985424553,30144,6.801874985424553
Malta,2021,18778,22,2021-05-31,514564,9,1.7490535676805996,30153,1.7490535676805996
Malta,2021,18785,23,2021-06-07,514564,14,2.7207499941698217,30167,2.7207499941698217
Malta,2021,18792,24,2021-06-14,514564,28,5.441499988339643,30195,5.441499988339643
Malta,2021,18799,25,2021-06-21,514564,51,9.911303550190064,30246,9.911303550190064
Malta,2021,18806,26,2021-06-28,514564,570,110.7733926197713,30816,110.7733926197713
Malta,2021,18813,27,2021-07-05,514564,1329,258.2769101608352,32145,258.2769101608352
Malta,2021,18820,28,2021-07-12,514564,1167,226.7939459425844,33312,226.7939459425844
Malta,2021,18827,29,2021-07-19,514564,733,142.45069612331994,34045,142.45069612331994
Malta,2021,18834,30,2021-07-26,514564,465,90.367767663497645,34510,90.367767663497645
Malta,2021,18841,31,2021-08-02,514564,474,92.11682123117824,34984,92.11682123117824
Malta,2021,18848,32,2021-08-09,514564,273,53.054624886311515,35257,53.054624886311515
Malta,2021,18855,33,2021-08-16,514564,289,56.16405345107703,35546,56.16405345107703
Malta,2021,18862,34,2021-08-23,514564,388,75.40364269556362,35934,75.40364269556362
Malta,2021,18869,35,2021-08-30,514564,286,55.581035595183494,36220,55.581035595183494
Malta,2021,18876,36,2021-09-06,514564,178,34.5923927830163,36398,34.5923927830163
Malta,2021,18883,37,2021-09-13,514564,106,20.599964241571506,36504,20.599964241571506
Malta,2021,18890,38,2021-09-20,514564,94,18.26789281799737,36598,18.26789281799737
Malta,2021,18897,39,2021-09-27,514564,135,26.235803515208993,36733,26.235803515208993
Malta,2021,18904,40,2021-10-04,514564,96,18.65657138859306,36829,18.65657138859306
Malta,2021,18911,41,2021-10-11,514564,86,16.713178535614617,36915,16.713178535614617
Malta,2021,18918,42,2021-10-18,514564,90,17.490535676805994,37005,17.490535676805994
Malta,2021,18925,43,2021-10-25,514564,259,50.333874892141694,37264,50.333874892141694
Moldova,2020,18330,10,2020-03-09,4033963,23,0.5701589231234893,23,0.5701589231234893
Moldova,2020,18337,11,2020-03-16,4033963,71,1.7600558061638145,94,1.7600558061638145
Moldova,2020,18344,12,2020-03-23,4033963,169,4.1894286090378126,263,4.1894286090378126
Moldova,2020,18351,13,2020-03-30,4033963,601,14.898500556400741,864,14.898500556400741
Moldova,2020,18358,14,2020-04-06,4033963,798,19.78203568054541,1662,19.78203568054541
Moldova,2020,18365,15,2020-04-13,4033963,810,20.07950990130549,2472,20.07950990130549
Moldova,2020,18372,16,2020-04-20,4033963,936,23.202989219286344,3408,23.202989219286344
Moldova,2020,18379,17,2020-04-27,4033963,713,17.674926616828166,4121,17.674926616828166
Moldova,2020,18386,18,2020-05-04,4033963,806,19.980351827718795,4927,19.980351827718795
Moldova,2020,18393,19,2020-05-11,4033963,1133,28.086524343431012,6060,28.086524343431012
Moldova,2020,18400,20,2020-05-18,4033963,1033,25.60757250376367,7093,25.60757250376367
Moldova,2020,18407,21,2020-05-25,4033963,1158,28.70626230334785,8251,28.70626230334785
Moldova,2020,18414,22,2020-06-01,4033963,1449,35.92001215677982,9700,35.92001215677982
Moldova,2020,18421,23,2020-06-08,4033963,2040,50.57061752921383,11740,50.57061752921383
Moldova,2020,18428,24,2020-06-15,4033963,2460,60.982215255816676,14200,60.982215255816676
Moldova,2020,18435,25,2020-06-22,4033963,2050,50.81851271318056,16250,50.81851271318056
Moldova,2020,18442,26,2020-06-29,4033963,1564,38.770806772397265,17814,38.770806772397265
Moldova,2020,18449,27,2020-07-06,4033963,1568,38.869964845983965,19382,38.869964845983965
Moldova,2020,18456,28,2020-07-13,4033963,1598,39.613650397884165,20980,39.613650397884165
Moldova,2020,18463,29,2020-07-20,4033963,2054,50.91767078676725,23034,50.91767078676725
Moldova,2020,18470,30,2020-07-27,4033963,2328,57.70999882745578,25362,57.70999882745578
Moldova,2020,18477,31,2020-08-03,4033963,2298,56.96631327555558,27660,56.96631327555558
Moldova,2020,18484,32,2020-08-10,4033963,2523,62.5439549148071,30183,62.5439549148071
Moldova,2020,18491,33,2020-08-17,4033963,3295,81.681463117039,33478,81.681463117039
Moldova,2020,18498,34,2020-08-24,4033963,3222,79.87182827408184,36700,79.87182827408184
Moldova,2020,18505,35,2020-08-31,4033963,3097,76.77313847449766,39797,76.77313847449766
Moldova,2020,18512,36,2020-09-07,4033963,3181,78.85545801981823,42978,78.85545801981823
Moldova,2020,18519,37,2020-09-14,4033963,3618,89.68847755916453,46596,89.68847755916453
Moldova,2020,18526,38,2020-09-21,4033963,4279,106.07434921936567,50875,106.07434921936567
Moldova,2020,18533,39,2020-09-28,4033963,5704,141.39941293462533,56579,141.39941293462533
Moldova,2020,18540,40,2020-10-05,4033963,5572,138.12719650626443,62151,138.12719650626443
Moldova,2020,18547,41,2020-10-12,4033963,4899,121.44385062530321,67050,121.44385062530321
Moldova,2020,18554,42,2020-10-19,4033963,4453,110.38772542038686,71503,110.38772542038686
Moldova,2020,18561,43,2020-10-26,4033963,5079,125.90596393670442,76582,125.90596393670442
Moldova,2020,18568,44,2020-11-02,4033963,5764,142.88678403842573,82346,142.88678403842573
Moldova,2020,18575,45,2020-11-09,4033963,6933,171.865731044137,89279,171.865731044137
Moldova,2020,18582,46,2020-11-16,4033963,8662,214.72680835198537,97941,214.72680835198537
Moldova,2020,18589,47,2020-11-23,4033963,9076,224.98966896820818,107017,224.98966896820818
Moldova,2020,18596,48,2020-11-30,4033963,9618,238.4255879392052,116635,238.4255879392052
Moldova,2020,18603,49,2020-12-07,4033963,9883,244.99481031432364,126518,244.99481031432364
Moldova,2020,18610,50,2020-12-14,4033963,8689,215.39612534869556,135207,215.39612534869556
Moldova,2020,18617,51,2020-12-21,4033963,6148,152.40595910274834,141355,152.40595910274834
Moldova,2020,18624,52,2020-12-28,4033963,4518,111.99904411617062,145873,111.99904411617062
Moldova,2021,18631,0,2021-01-04,4033963,3518,87.20952571949718,149391,87.20952571949718
Moldova,2021,18631,1,2021-01-04,4033963,3463,85.84610220768013,152854,85.84610220768013
Moldova,2021,18638,2,2021-01-11,4033963,3348,82.99530759206269,156202,82.99530759206269
Moldova,2021,18645,3,2021-01-18,4033963,3602,89.29184526481775,159804,89.29184526481775
Moldova,2021,18652,4,2021-01-25,4033963,4765,118.12205516014896,164569,118.12205516014896
Moldova,2021,18659,5,2021-02-01,4033963,5617,139.24272483411474,170186,139.24272483411474
Moldova,2021,18666,6,2021-02-08,4033963,6566,162.76797779255784,176752,162.76797779255784
Moldova,2021,18673,7,2021-02-15,4033963,8701,215.69359956945564,185453,215.69359956945564
Moldova,2021,18680,8,2021-02-22,4033963,9799,242.91249076900309,195252,242.91249076900309
Moldova,2021,18687,9,2021-03-01,4033963,9211,228.3362539517591,204463,228.3362539517591
Moldova,2021,18694,10,2021-03-08,4033963,10571,262.04999897123497,215034,262.04999897123497
Moldova,2021,18701,11,2021-03-15,4033963,11487,284.75719782258784,226521,284.75719782258784
Moldova,2021,18708,12,2021-03-22,4033963,8566,212.34701458590473,235087,212.34701458590473
Moldova,2021,18715,13,2021-03-29,4033963,6130,151.95974777160822,241217,151.95974777160822
Moldova,2021,18722,14,2021-04-05,4033963,4680,116.01494609643173,245897,116.01494609643173
Moldova,2021,18729,15,2021-04-12,4033963,3242,80.3676186420153,249139,80.3676186420153
Moldova,2021,18736,16,2021-04-19,4033963,2196,54.437782399094885,251335,54.437782399094885
Moldova,2021,18743,17,2021-04-26,4033963,1414,35.05237901289625,252749,35.05237901289625
Moldova,2021,18750,18,2021-05-03,4033963,1096,27.169312162754096,253845,27.169312162754096
Moldova,2021,18757,19,2021-05-10,4033963,831,20.600089787635632,254676,20.600089787635632
Moldova,2021,18764,20,2021-05-17,4033963,469,11.626284128039845,255145,11.626284128039845
Moldova,2021,18771,21,2021-05-24,4033963,308,7.635171666175421,255453,7.635171666175421
Moldova,2021,18778,22,2021-05-31,4033963,344,8.527594328455665,255797,8.527594328455665
Moldova,2021,18785,23,2021-06-07,4033963,343,8.502804810058992,256140,8.502804810058992
Moldova,2021,18792,24,2021-06-14,4033963,419,10.386808208206173,256559,10.386808208206173
Moldova,2021,18799,25,2021-06-21,4033963,411,10.188492061032786,256970,10.188492061032786
Moldova,2021,18806,26,2021-06-28,4033963,497,12.320390643146702,257467,12.320390643146702
Moldova,2021,18813,27,2021-07-05,4033963,540,13.38633993420366,258007,13.38633993420366
Moldova,2021,18820,28,2021-07-12,4033963,617,15.295132850747516,258624,15.295132850747516
Moldova,2021,18827,29,2021-07-19,4033963,925,22.930304516922938,259549,22.930304516922938
Moldova,2021,18834,30,2021-07-26,4033963,1081,26.797469386803993,260630,26.797469386803993
Moldova,2021,18841,31,2021-08-02,4033963,1414,35.05237901289625,262044,35.05237901289625
Moldova,2021,18848,32,2021-08-09,4033963,2388,59.19736993125618,264432,59.19736993125618
Moldova,2021,18855,33,2021-08-16,4033963,2556,63.36200902189732,266988,63.36200902189732
Moldova,2021,18862,34,2021-08-23,4033963,3231,80.0949339396519,270219,80.0949339396519
Moldova,2021,18869,35,2021-08-30,4033963,4593,113.85825799592114,274812,113.85825799592114
Moldova,2021,18876,36,2021-09-06,4033963,6888,170.75020271628668,281700,170.75020271628668
Moldova,2021,18883,37,2021-09-13,4033963,7325,181.583222255633,289025,181.583222255633
Moldova,2021,18890,38,2021-09-20,4033963,8207,203.44757748149897,297232,203.44757748149897
Moldova,2021,18897,39,2021-09-27,4033963,9415,233.39331570468048,306647,233.39331570468048
Moldova,2021,18904,40,2021-10-04,4033963,9882,244.97002079592698,316529,244.97002079592698
Moldova,2021,18911,41,2021-10-11,4033963,11471,284.36056552824107,328000,284.36056552824107
Moldova,2021,18918,42,2021-10-18,4033963,9768,242.1440156987062,337768,242.1440156987062
Moldova,2021,18925,43,2021-10-25,4033963,8196,203.17489277913555,345964,203.17489277913555
Monaco,2020,18267,0,2020-01-06,39244,0,0,0,0
Monaco,2020,18267,1,2020-01-06,39244,0,0,0,0
Monaco,2020,18274,2,2020-01-13,39244,0,0,0,0
Monaco,2020,18281,3,2020-01-20,39244,0,0,0,0
Monaco,2020,18288,4,2020-01-27,39244,0,0,0,0
Monaco,2020,18295,5,2020-02-03,39244,0,0,0,0
Monaco,2020,18302,6,2020-02-10,39244,0,0,0,0
Monaco,2020,18309,7,2020-02-17,39244,0,0,0,0
Monaco,2020,18316,8,2020-02-24,39244,1,2.5481602283151563,1,2.5481602283151563
Monaco,2020,18323,9,2020-03-02,39244,0,0,1,0
Monaco,2020,18330,10,2020-03-09,39244,8,20.38528182652125,9,20.38528182652125
Monaco,2020,18337,11,2020-03-16,39244,11,28.02976251146672,20,28.02976251146672
Monaco,2020,18344,12,2020-03-23,39244,15,38.22240342472735,35,38.22240342472735
Monaco,2020,18351,13,2020-03-30,39244,16,40.7705636530425,51,40.7705636530425
Monaco,2020,18358,14,2020-04-06,39244,13,33.12608296809704,64,33.12608296809704
Monaco,2020,18365,15,2020-04-13,39244,1,2.5481602283151563,65,2.5481602283151563
Monaco,2020,18372,16,2020-04-20,39244,0,0,65,0
Monaco,2020,18379,17,2020-04-27,39244,1,2.5481602283151563,66,2.5481602283151563
Monaco,2020,18386,18,2020-05-04,39244,0,0,66,0
Monaco,2020,18393,19,2020-05-11,39244,0,0,66,0
Monaco,2020,18400,20,2020-05-18,39244,1,2.5481602283151563,67,2.5481602283151563
Monaco,2020,18407,21,2020-05-25,39244,0,0,67,0
Monaco,2020,18414,22,2020-06-01,39244,0,0,67,0
Monaco,2020,18421,23,2020-06-08,39244,0,0,67,0
Monaco,2020,18428,24,2020-06-15,39244,1,2.5481602283151563,68,2.5481602283151563
Monaco,2020,18435,25,2020-06-22,39244,2,5.096320456630313,70,5.096320456630313
Monaco,2020,18442,26,2020-06-29,39244,5,12.740801141575782,75,12.740801141575782
Monaco,2020,18449,27,2020-07-06,39244,1,2.5481602283151563,76,2.5481602283151563
Monaco,2020,18456,28,2020-07-13,39244,0,0,76,0
Monaco,2020,18463,29,2020-07-20,39244,5,12.740801141575782,81,12.740801141575782
Monaco,2020,18470,30,2020-07-27,39244,3,7.644480684945469,84,7.644480684945469
Monaco,2020,18477,31,2020-08-03,39244,10,25.481602283151563,94,25.481602283151563
Monaco,2020,18484,32,2020-08-10,39244,5,12.740801141575782,99,12.740801141575782
Monaco,2020,18491,33,2020-08-17,39244,12,30.577922739781876,111,30.577922739781876
Monaco,2020,18498,34,2020-08-24,39244,20,50.963204566303126,131,50.963204566303126
Monaco,2020,18505,35,2020-08-31,39244,17,43.31872388135766,148,43.31872388135766
Monaco,2020,18512,36,2020-09-07,39244,23,58.6076852512486,171,58.6076852512486
Monaco,2020,18519,37,2020-09-14,39244,22,56.05952502293344,193,56.05952502293344
Monaco,2020,18526,38,2020-09-21,39244,17,43.31872388135766,210,43.31872388135766
Monaco,2020,18533,39,2020-09-28,39244,12,30.577922739781876,222,30.577922739781876
Monaco,2020,18540,40,2020-10-05,39244,12,30.577922739781876,234,30.577922739781876
Monaco,2020,18547,41,2020-10-12,39244,31,78.99296707776985,265,78.99296707776985
Monaco,2020,18554,42,2020-10-19,39244,41,104.47456936092142,306,104.47456936092142
Monaco,2020,18561,43,2020-10-26,39244,60,152.8896136989094,366,152.8896136989094
Monaco,2020,18568,44,2020-11-02,39244,120,305.7792273978188,486,305.7792273978188
Monaco,2020,18575,45,2020-11-09,39244,62,157.9859341555397,548,157.9859341555397
Monaco,2020,18582,46,2020-11-16,39244,34,86.63744776271533,582,86.63744776271533
Monaco,2020,18589,47,2020-11-23,39244,26,66.25216593619407,608,66.25216593619407
Monaco,2020,18596,48,2020-11-30,39244,30,76.4448068494547,638,76.4448068494547
Monaco,2020,18603,49,2020-12-07,39244,30,76.4448068494547,668,76.4448068494547
Monaco,2020,18610,50,2020-12-14,39244,60,152.8896136989094,728,152.8896136989094
Monaco,2020,18617,51,2020-12-21,39244,75,191.11201712363675,803,191.11201712363675
Monaco,2020,18624,52,2020-12-28,39244,104,265.0086637447763,907,265.0086637447763
Monaco,2021,18631,0,2021-01-04,39244,150,382.2240342472735,1057,382.2240342472735
Monaco,2021,18631,1,2021-01-04,39244,148,377.12771379064316,1205,377.12771379064316
Monaco,2021,18638,2,2021-01-11,39244,152,387.3203547039038,1357,387.3203547039038
Monaco,2021,18645,3,2021-01-18,39244,132,336.3571501376006,1489,336.3571501376006
Monaco,2021,18652,4,2021-01-25,39244,166,422.99459790031597,1655,422.99459790031597
Monaco,2021,18659,5,2021-02-01,39244,105,267.5568239730914,1760,267.5568239730914
Monaco,2021,18666,6,2021-02-08,39244,110,280.2976251146672,1870,280.2976251146672
Monaco,2021,18673,7,2021-02-15,39244,86,219.14177963510346,1956,219.14177963510346
Monaco,2021,18680,8,2021-02-22,39244,67,170.72673529711548,2023,170.72673529711548
Monaco,2021,18687,9,2021-03-01,39244,84,214.04545917847315,2107,214.04545917847315
Monaco,2021,18694,10,2021-03-08,39244,66,168.1785750688003,2173,168.1785750688003
Monaco,2021,18701,11,2021-03-15,39244,86,219.14177963510346,2259,219.14177963510346
Monaco,2021,18708,12,2021-03-22,39244,70,178.37121598206096,2329,178.37121598206096
Monaco,2021,18715,13,2021-03-29,39244,46,117.2153705024972,2375,117.2153705024972
Monaco,2021,18722,14,2021-04-05,39244,24,61.15584547956375,2399,61.15584547956375
Monaco,2021,18729,15,2021-04-12,39244,40,101.92640913260625,2439,101.92640913260625
Monaco,2021,18736,16,2021-04-19,39244,18,45.86688410967282,2457,45.86688410967282
Monaco,2021,18743,17,2021-04-26,39244,22,56.05952502293344,2479,56.05952502293344
Monaco,2021,18750,18,2021-05-03,39244,14,35.67424319641219,2493,35.67424319641219
Monaco,2021,18757,19,2021-05-10,39244,8,20.38528182652125,2501,20.38528182652125
Monaco,2021,18764,20,2021-05-17,39244,3,7.644480684945469,2504,7.644480684945469
Monaco,2021,18771,21,2021-05-24,39244,4,10.192640913260625,2508,10.192640913260625
Monaco,2021,18778,22,2021-05-31,39244,17,43.31872388135766,2525,43.31872388135766
Monaco,2021,18785,23,2021-06-07,39244,23,58.6076852512486,2548,58.6076852512486
Monaco,2021,18792,24,2021-06-14,39244,23,58.6076852512486,2571,58.6076852512486
Monaco,2021,18799,25,2021-06-21,39244,16,40.7705636530425,2587,40.7705636530425
Monaco,2021,18806,26,2021-06-28,39244,35,89.18560799103048,2622,89.18560799103048
Monaco,2021,18813,27,2021-07-05,39244,60,152.8896136989094,2682,152.8896136989094
Monaco,2021,18820,28,2021-07-12,39244,103,262.46050351646113,2785,262.46050351646113
Monaco,2021,18827,29,2021-07-19,39244,106,270.1049842014066,2891,270.1049842014066
Monaco,2021,18834,30,2021-07-26,39244,95,242.07522168993987,2986,242.07522168993987
Monaco,2021,18841,31,2021-08-02,39244,73,186.0156966670064,3059,186.0156966670064
Monaco,2021,18848,32,2021-08-09,39244,74,188.56385689532158,3133,188.56385689532158
Monaco,2021,18855,33,2021-08-16,39244,50,127.40801141575783,3183,127.40801141575783
Monaco,2021,18862,34,2021-08-23,39244,57,145.2451330139639,3240,145.2451330139639
Monaco,2021,18869,35,2021-08-30,39244,36,91.73376821934563,3276,91.73376821934563
Monaco,2021,18876,36,2021-09-06,39244,14,35.67424319641219,3290,35.67424319641219
Monaco,2021,18883,37,2021-09-13,39244,13,33.12608296809704,3303,33.12608296809704
Monaco,2021,18890,38,2021-09-20,39244,14,35.67424319641219,3317,35.67424319641219
Monaco,2021,18897,39,2021-09-27,39244,19,48.41504433798797,3336,48.41504433798797
Monaco,2021,18904,40,2021-10-04,39244,27,68.80032616450923,3363,68.80032616450923
Monaco,2021,18911,41,2021-10-11,39244,26,66.25216593619407,3389,66.25216593619407
Monaco,2021,18918,42,2021-10-18,39244,27,68.80032616450923,3416,68.80032616450923
Monaco,2021,18925,43,2021-10-25,39244,23,58.6076852512486,3439,58.6076852512486
Montenegro,2020,18337,11,2020-03-16,621873,21,3.37689528247729,21,3.37689528247729
Montenegro,2020,18344,12,2020-03-23,621873,64,10.291490384692695,85,10.291490384692695
Montenegro,2020,18351,13,2020-03-30,621873,129,20.743785306646213,214,20.743785306646213
Montenegro,2020,18358,14,2020-04-06,621873,58,9.326663161127755,272,9.326663161127755
Montenegro,2020,18365,15,2020-04-13,621873,36,5.788963341389641,308,5.788963341389641
Montenegro,2020,18372,16,2020-04-20,621873,13,2.0904589843907035,321,2.0904589843907035
Montenegro,2020,18379,17,2020-04-27,621873,1,0.16080453726082336,322,0.16080453726082336
Montenegro,2020,18386,18,2020-05-04,621873,2,0.3216090745216467,324,0.3216090745216467
Montenegro,2020,18393,19,2020-05-11,621873,0,0,324,0
Montenegro,2020,18400,20,2020-05-18,621873,0,0,324,0
Montenegro,2020,18407,21,2020-05-25,621873,0,0,324,0
Montenegro,2020,18414,22,2020-06-01,621873,0,0,324,0
Montenegro,2020,18421,23,2020-06-08,621873,1,0.16080453726082336,325,0.16080453726082336
Montenegro,2020,18428,24,2020-06-15,621873,37,5.949767878650464,362,5.949767878650464
Montenegro,2020,18435,25,2020-06-22,621873,119,19.13573993403798,481,19.13573993403798
Montenegro,2020,18442,26,2020-06-29,621873,300,48.241361178247004,781,48.241361178247004
Montenegro,2020,18449,27,2020-07-06,621873,440,70.75399639476227,1221,70.75399639476227
Montenegro,2020,18456,28,2020-07-13,621873,550,88.44249549345284,1771,88.44249549345284
Montenegro,2020,18463,29,2020-07-20,621873,798,128.32202073413703,2569,128.32202073413703
Montenegro,2020,18470,30,2020-07-27,621873,689,110.79432617270729,3258,110.79432617270729
Montenegro,2020,18477,31,2020-08-03,621873,360,57.889633413896405,3618,57.889633413896405
Montenegro,2020,18484,32,2020-08-10,621873,417,67.05549203776334,4035,67.05549203776334
Montenegro,2020,18491,33,2020-08-17,621873,308,49.52779747633359,4343,49.52779747633359
Montenegro,2020,18498,34,2020-08-24,621873,447,71.87962815558804,4790,71.87962815558804
Montenegro,2020,18505,35,2020-08-31,621873,763,122.69386193000821,5553,122.69386193000821
Montenegro,2020,18512,36,2020-09-07,621873,1159,186.37245868529428,6712,186.37245868529428
Montenegro,2020,18519,37,2020-09-14,621873,1900,305.5286207955644,8612,305.5286207955644
Montenegro,2020,18526,38,2020-09-21,621873,1701,273.5285178806605,10313,273.5285178806605
Montenegro,2020,18533,39,2020-09-28,621873,1814,291.69943059113353,12127,291.69943059113353
Montenegro,2020,18540,40,2020-10-05,621873,1742,280.12150390835427,13869,280.12150390835427
Montenegro,2020,18547,41,2020-10-12,621873,1746,280.7647220573976,15615,280.7647220573976
Montenegro,2020,18554,42,2020-10-19,621873,1182,190.07096304229322,16797,190.07096304229322
Montenegro,2020,18561,43,2020-10-26,621873,1917,308.26229792899835,18714,308.26229792899835
Montenegro,2020,18568,44,2020-11-02,621873,4091,657.8513619340283,22805,657.8513619340283
Montenegro,2020,18575,45,2020-11-09,621873,4372,703.0374369043197,27177,703.0374369043197
Montenegro,2020,18582,46,2020-11-16,621873,3885,624.7256272582987,31062,624.7256272582987
Montenegro,2020,18589,47,2020-11-23,621873,3819,614.1125277990844,34881,614.1125277990844
Montenegro,2020,18596,48,2020-11-30,621873,3365,541.1072678826706,38246,541.1072678826706
Montenegro,2020,18603,49,2020-12-07,621873,3180,511.35842848941826,41426,511.35842848941826
Montenegro,2020,18610,50,2020-12-14,621873,2529,406.67467473262224,43955,406.67467473262224
Montenegro,2020,18617,51,2020-12-21,621873,2739,440.44362755739513,46694,440.44362755739513
Montenegro,2020,18624,52,2020-12-28,621873,2501,402.1721476893192,49195,402.1721476893192
Montenegro,2021,18631,0,2021-01-04,621873,3236,520.3634825760244,52431,520.3634825760244
Montenegro,2021,18631,1,2021-01-04,621873,3062,492.3834930926411,55493,492.3834930926411
Montenegro,2021,18638,2,2021-01-11,621873,2823,453.9512086873043,58316,453.9512086873043
Montenegro,2021,18645,3,2021-01-18,621873,3343,537.5695680629325,61659,537.5695680629325
Montenegro,2021,18652,4,2021-01-25,621873,3568,573.7505889466178,65227,573.7505889466178
Montenegro,2021,18659,5,2021-02-01,621873,3694,594.0119606414814,68921,594.0119606414814
Montenegro,2021,18666,6,2021-02-08,621873,3074,494.31314753977097,71995,494.31314753977097
Montenegro,2021,18673,7,2021-02-15,621873,3838,617.1678140070401,75833,617.1678140070401
Montenegro,2021,18680,8,2021-02-22,621873,4358,700.7861733826682,80191,700.7861733826682
Montenegro,2021,18687,9,2021-03-01,621873,3502,563.1374894874034,83693,563.1374894874034
Montenegro,2021,18694,10,2021-03-08,621873,3519,565.8711666208374,87212,565.8711666208374
Montenegro,2021,18701,11,2021-03-15,621873,2871,461.66982647582387,90083,461.66982647582387
Montenegro,2021,18708,12,2021-03-22,621873,2436,391.7198527673657,92519,391.7198527673657
Montenegro,2021,18715,13,2021-03-29,621873,1900,305.5286207955644,94419,305.5286207955644
Montenegro,2021,18722,14,2021-04-05,621873,1132,182.03073617925205,95551,182.03073617925205
Montenegro,2021,18729,15,2021-04-12,621873,1109,178.3322318222531,96660,178.3322318222531
Montenegro,2021,18736,16,2021-04-19,621873,1058,170.1312004219511,97718,170.1312004219511
Montenegro,2021,18743,17,2021-04-26,621873,585,94.07065429758165,98303,94.07065429758165
Montenegro,2021,18750,18,2021-05-03,621873,595,95.6786996701899,98898,95.6786996701899
Montenegro,2021,18757,19,2021-05-10,621873,350,56.281588041288174,99248,56.281588041288174
Montenegro,2021,18764,20,2021-05-17,621873,357,57.407219802113936,99605,57.407219802113936
Montenegro,2021,18771,21,2021-05-24,621873,207,33.286539212990434,99812,33.286539212990434
Montenegro,2021,18778,22,2021-05-31,621873,144,23.155853365558563,99956,23.155853365558563
Montenegro,2021,18785,23,2021-06-07,621873,119,19.13573993403798,100075,19.13573993403798
Montenegro,2021,18792,24,2021-06-14,621873,115,18.492521784994686,100190,18.492521784994686
Montenegro,2021,18799,25,2021-06-21,621873,137,22.030221604732798,100327,22.030221604732798
Montenegro,2021,18806,26,2021-06-28,621873,161,25.88953049899256,100488,25.88953049899256
Montenegro,2021,18813,27,2021-07-05,621873,202,32.48251652668632,100690,32.48251652668632
Montenegro,2021,18820,28,2021-07-12,621873,440,70.75399639476227,101130,70.75399639476227
Montenegro,2021,18827,29,2021-07-19,621873,962,154.69396484491207,102092,154.69396484491207
Montenegro,2021,18834,30,2021-07-26,621873,1630,262.1113957351421,103722,262.1113957351421
Montenegro,2021,18841,31,2021-08-02,621873,2771,445.58937274974153,106493,445.58937274974153
Montenegro,2021,18848,32,2021-08-09,621873,3469,557.8309397577962,109962,557.8309397577962
Montenegro,2021,18855,33,2021-08-16,621873,4402,707.8615730221444,114364,707.8615730221444
Montenegro,2021,18862,34,2021-08-23,621873,3740,601.4089693554794,118104,601.4089693554794
Montenegro,2021,18869,35,2021-08-30,621873,3804,611.700459740172,121908,611.700459740172
Montenegro,2021,18876,36,2021-09-06,621873,4776,768.0024699576924,126684,768.0024699576924
Montenegro,2021,18883,37,2021-09-13,621873,2964,476.6246484410804,129648,476.6246484410804
Montenegro,2021,18890,38,2021-09-20,621873,3048,490.1322295709896,132696,490.1322295709896
Montenegro,2021,18897,39,2021-09-27,621873,2602,418.41340595266234,135298,418.41340595266234
Montenegro,2021,18904,40,2021-10-04,621873,2471,397.3480115714945,137769,397.3480115714945
Montenegro,2021,18911,41,2021-10-11,621873,3153,507.016705983376,140922,507.016705983376
Montenegro,2021,18918,42,2021-10-18,621873,3392,545.4489903887128,144314,545.4489903887128
Montenegro,2021,18925,43,2021-10-25,621873,4265,685.8313514174116,148579,685.8313514174116
Netherlands,2020,18267,0,2020-01-06,17407585,0,0,0,0
Netherlands,2020,18267,1,2020-01-06,17407585,0,0,0,0
Netherlands,2020,18274,2,2020-01-13,17407585,0,0,0,0
Netherlands,2020,18281,3,2020-01-20,17407585,0,0,0,0
Netherlands,2020,18288,4,2020-01-27,17407585,0,0,0,0
Netherlands,2020,18295,5,2020-02-03,17407585,0,0,0,0
Netherlands,2020,18302,6,2020-02-10,17407585,0,0,0,0
Netherlands,2020,18309,7,2020-02-17,17407585,0,0,0,0
Netherlands,2020,18316,8,2020-02-24,17407585,5,0.02872311121847172,5,0.02872311121847172
Netherlands,2020,18323,9,2020-03-02,17407585,158,0.9076503145037063,163,0.9076503145037063
Netherlands,2020,18330,10,2020-03-09,17407585,946,5.434412642534849,1109,5.434412642534849
Netherlands,2020,18337,11,2020-03-16,17407585,3076,17.6704580216038,4185,17.6704580216038
Netherlands,2020,18344,12,2020-03-23,17407585,6557,37.66748805190381,10742,37.66748805190381
Netherlands,2020,18351,13,2020-03-30,17407585,6919,39.74704130412116,17661,39.74704130412116
Netherlands,2020,18358,14,2020-04-06,17407585,7693,44.193378920740585,25354,44.193378920740585
Netherlands,2020,18365,15,2020-04-13,17407585,7063,40.57426690721315,32417,40.57426690721315
Netherlands,2020,18372,16,2020-04-20,17407585,5149,29.579059932782176,37566,29.579059932782176
Netherlands,2020,18379,17,2020-04-27,17407585,2746,15.774732681184668,40312,15.774732681184668
Netherlands,2020,18386,18,2020-05-04,17407585,2049,11.77073097732971,42361,11.77073097732971
Netherlands,2020,18393,19,2020-05-11,17407585,1392,7.9965141632225265,43753,7.9965141632225265
Netherlands,2020,18400,20,2020-05-18,17407585,1234,7.08886384871882,44987,7.08886384871882
Netherlands,2020,18407,21,2020-05-25,17407585,1209,6.945248292626461,46196,6.945248292626461
Netherlands,2020,18414,22,2020-06-01,17407585,1126,6.468444646399831,47322,6.468444646399831
Netherlands,2020,18421,23,2020-06-08,17407585,1205,6.922269803651684,48527,6.922269803651684
Netherlands,2020,18428,24,2020-06-15,17407585,823,4.727824106560445,49350,4.727824106560445
Netherlands,2020,18435,25,2020-06-22,17407585,564,3.23996694544361,49914,3.23996694544361
Netherlands,2020,18442,26,2020-06-29,17407585,483,2.774652543704368,50397,2.774652543704368
Netherlands,2020,18449,27,2020-07-06,17407585,436,2.504655298250734,50833,2.504655298250734
Netherlands,2020,18456,28,2020-07-13,17407585,797,4.578463928224392,51630,4.578463928224392
Netherlands,2020,18463,29,2020-07-20,17407585,1238,7.111842337693598,52868,7.111842337693598
Netherlands,2020,18470,30,2020-07-27,17407585,2153,12.368171690673922,55021,12.368171690673922
Netherlands,2020,18477,31,2020-08-03,17407585,3470,19.933839185619373,58491,19.933839185619373
Netherlands,2020,18484,32,2020-08-10,17407585,4416,25.36825182815422,62907,25.36825182815422
Netherlands,2020,18491,33,2020-08-17,17407585,3558,20.439365943064473,66465,20.439365943064473
Netherlands,2020,18498,34,2020-08-24,17407585,3579,20.560003010182054,70044,20.560003010182054
Netherlands,2020,18505,35,2020-08-31,17407585,4624,26.563133254842644,74668,26.563133254842644
Netherlands,2020,18512,36,2020-09-07,17407585,7320,42.05063482384259,81988,42.05063482384259
Netherlands,2020,18519,37,2020-09-14,17407585,11640,66.86740291660216,93628,66.86740291660216
Netherlands,2020,18526,38,2020-09-21,17407585,17758,102.01300180352415,111386,102.01300180352415
Netherlands,2020,18533,39,2020-09-28,17407585,24167,138.8302857633612,135553,138.8302857633612
Netherlands,2020,18540,40,2020-10-05,17407585,38610,221.7998648290386,174163,221.7998648290386
Netherlands,2020,18547,41,2020-10-12,17407585,53368,306.57899990147973,227531,306.57899990147973
Netherlands,2020,18554,42,2020-10-19,17407585,62878,361.2103574390129,290409,361.2103574390129
Netherlands,2020,18561,43,2020-10-26,17407585,68407,392.97237382439897,358816,392.97237382439897
Netherlands,2020,18568,44,2020-11-02,17407585,50047,287.5011094301708,408863,287.5011094301708
Netherlands,2020,18575,45,2020-11-09,17407585,37698,216.56076934278937,446561,216.56076934278937
Netherlands,2020,18582,46,2020-11-16,17407585,36685,210.741467009927,483246,210.741467009927
Netherlands,2020,18589,47,2020-11-23,17407585,34287,196.96586286954795,517533,196.96586286954795
Netherlands,2020,18596,48,2020-11-30,17407585,38293,219.9788195777875,555826,219.9788195777875
Netherlands,2020,18603,49,2020-12-07,17407585,56302,323.43372156447896,612128,323.43372156447896
Netherlands,2020,18610,50,2020-12-14,17407585,76213,437.814895058677,688341,437.814895058677
Netherlands,2020,18617,51,2020-12-21,17407585,73178,420.37996654906465,761519,420.37996654906465
Netherlands,2020,18624,52,2020-12-28,17407585,58183,334.239356004868,819702,334.239356004868
Netherlands,2021,18631,0,2021-01-04,17407585,51812,297.6403676902913,871514,297.6403676902913
Netherlands,2021,18631,1,2021-01-04,17407585,39882,229.1070243230178,911396,229.1070243230178
Netherlands,2021,18638,2,2021-01-11,17407585,36525,209.8223274509359,947921,209.8223274509359
Netherlands,2021,18645,3,2021-01-18,17407585,29710,170.67272686015895,977631,170.67272686015895
Netherlands,2021,18652,4,2021-01-25,17407585,27326,156.97754743119162,1004957,156.97754743119162
Netherlands,2021,18659,5,2021-02-01,17407585,23540,135.22840761656485,1028497,135.22840761656485
Netherlands,2021,18666,6,2021-02-08,17407585,27342,157.06946138709074,1055839,157.06946138709074
Netherlands,2021,18673,7,2021-02-15,17407585,31987,183.75323170905097,1087826,183.75323170905097
Netherlands,2021,18680,8,2021-02-22,17407585,31311,179.86986707231358,1119137,179.86986707231358
Netherlands,2021,18687,9,2021-03-01,17407585,37029,212.71761706175784,1156166,212.71761706175784
Netherlands,2021,18694,10,2021-03-08,17407585,44403,255.07846148675995,1200569,255.07846148675995
Netherlands,2021,18701,11,2021-03-15,17407585,50962,292.75743878315114,1251531,292.75743878315114
Netherlands,2021,18708,12,2021-03-22,17407585,49757,285.83516897949943,1301288,285.83516897949943
Netherlands,2021,18715,13,2021-03-29,17407585,48484,278.5222648632766,1349772,278.5222648632766
Netherlands,2021,18722,14,2021-04-05,17407585,53179,305.4932662974215,1402951,305.4932662974215
Netherlands,2021,18729,15,2021-04-12,17407585,57350,329.4540856758706,1460301,329.4540856758706
Netherlands,2021,18736,16,2021-04-19,17407585,46473,266.9698295312072,1506774,266.9698295312072
Netherlands,2021,18743,17,2021-04-26,17407585,52463,301.38011677093635,1559237,301.38011677093635
Netherlands,2021,18750,18,2021-05-03,17407585,38178,219.31818801976266,1597415,219.31818801976266
Netherlands,2021,18757,19,2021-05-10,17407585,28081,161.31473722518086,1625496,161.31473722518086
Netherlands,2021,18764,20,2021-05-17,17407585,21131,121.38961263150517,1646627,121.38961263150517
Netherlands,2021,18771,21,2021-05-24,17407585,15901,91.34523829698375,1662528,91.34523829698375
Netherlands,2021,18778,22,2021-05-31,17407585,9899,56.866015590330306,1672427,56.866015590330306
Netherlands,2021,18785,23,2021-06-07,17407585,6294,36.156652401812195,1678721,36.156652401812195
Netherlands,2021,18792,24,2021-06-14,17407585,4330,24.874214315196507,1683051,24.874214315196507
Netherlands,2021,18799,25,2021-06-21,17407585,5813,33.39348910259522,1688864,33.39348910259522
Netherlands,2021,18806,26,2021-06-28,17407585,39109,224.6664313286421,1727973,224.6664313286421
Netherlands,2021,18813,27,2021-07-05,17407585,70110,402.7554655054104,1798083,402.7554655054104
Netherlands,2021,18820,28,2021-07-12,17407585,44977,258.3758746546405,1843060,258.3758746546405
Netherlands,2021,18827,29,2021-07-19,17407585,24396,140.1458042571672,1867456,140.1458042571672
Netherlands,2021,18834,30,2021-07-26,17407585,18036,103.61000678727117,1885492,103.61000678727117
Netherlands,2021,18841,31,2021-08-02,17407585,16113,92.56309821264696,1901605,92.56309821264696
Netherlands,2021,18848,32,2021-08-09,17407585,16918,97.1875191188209,1918523,97.1875191188209
Netherlands,2021,18855,33,2021-08-16,17407585,17830,102.42661460507014,1936353,102.42661460507014
Netherlands,2021,18862,34,2021-08-23,17407585,17658,101.43853957915472,1954011,101.43853957915472
Netherlands,2021,18869,35,2021-08-30,17407585,16716,96.02710542559464,1970727,96.02710542559464
Netherlands,2021,18876,36,2021-09-06,17407585,14023,80.55683772332578,1984750,80.55683772332578
Netherlands,2021,18883,37,2021-09-13,17407585,11613,66.71229811602241,1996363,66.71229811602241
Netherlands,2021,18890,38,2021-09-20,17407585,11543,66.31017455896381,2007906,66.31017455896381
Netherlands,2021,18897,39,2021-09-27,17407585,16133,92.67799065752085,2024039,92.67799065752085
Netherlands,2021,18904,40,2021-10-04,17407585,23532,135.18245063861528,2047571,135.18245063861528
Netherlands,2021,18911,41,2021-10-11,17407585,34839,200.13689434806724,2082410,200.13689434806724
Netherlands,2021,18918,42,2021-10-18,17407585,49474,284.20944088453393,2131884,284.20944088453393
Netherlands,2021,18925,43,2021-10-25,17407585,68941,396.04000210253173,2200825,396.04000210253173
Norway,2020,18267,0,2020-01-06,5367580,0,0,0,0
Norway,2020,18267,1,2020-01-06,5367580,0,0,0,0
Norway,2020,18274,2,2020-01-13,5367580,0,0,0,0
Norway,2020,18281,3,2020-01-20,5367580,0,0,0,0
Norway,2020,18288,4,2020-01-27,5367580,0,0,0,0
Norway,2020,18295,5,2020-02-03,5367580,0,0,0,0
Norway,2020,18302,6,2020-02-10,5367580,0,0,0,0
Norway,2020,18309,7,2020-02-17,5367580,1,0.018630369738317828,1,0.018630369738317828
Norway,2020,18316,8,2020-02-24,5367580,30,0.5589110921495348,31,0.5589110921495348
Norway,2020,18323,9,2020-03-02,5367580,218,4.061420602953286,249,4.061420602953286
Norway,2020,18330,10,2020-03-09,5367580,1216,22.654529601794476,1465,22.654529601794476
Norway,2020,18337,11,2020-03-16,5367580,1438,26.790471683701035,2903,26.790471683701035
Norway,2020,18344,12,2020-03-23,5367580,1733,32.28643075650479,4636,32.28643075650479
Norway,2020,18351,13,2020-03-30,5367580,1192,22.207400728074848,5828,22.207400728074848
Norway,2020,18358,14,2020-04-06,5367580,762,14.196341740598184,6590,14.196341740598184
Norway,2020,18365,15,2020-04-13,5367580,575,10.712462599532751,7165,10.712462599532751
Norway,2020,18372,16,2020-04-20,5367580,423,7.880646399308441,7588,7.880646399308441
Norway,2020,18379,17,2020-04-27,5367580,309,5.756784249140209,7897,5.756784249140209
Norway,2020,18386,18,2020-05-04,5367580,221,4.11731171216824,8118,4.11731171216824
Norway,2020,18393,19,2020-05-11,5367580,126,2.347426587028046,8244,2.347426587028046
Norway,2020,18400,20,2020-05-18,5367580,108,2.012079931738325,8352,2.012079931738325
Norway,2020,18407,21,2020-05-25,5367580,86,1.6022117974953332,8438,1.6022117974953332
Norway,2020,18414,22,2020-06-01,5367580,114,2.1238621501682324,8552,2.1238621501682324
Norway,2020,18421,23,2020-06-08,5367580,82,1.5276903185420618,8634,1.5276903185420618
Norway,2020,18428,24,2020-06-15,5367580,110,2.049340671214961,8744,2.049340671214961
Norway,2020,18435,25,2020-06-22,5367580,112,2.0866014106915967,8856,2.0866014106915967
Norway,2020,18442,26,2020-06-29,5367580,67,1.2482347724672944,8923,1.2482347724672944
Norway,2020,18449,27,2020-07-06,5367580,65,1.2109740329906586,8988,1.2109740329906586
Norway,2020,18456,28,2020-07-13,5367580,53,0.9874095961308448,9041,0.9874095961308448
Norway,2020,18463,29,2020-07-20,5367580,94,1.7512547554018758,9135,1.7512547554018758
Norway,2020,18470,30,2020-07-27,5367580,199,3.7074435779252477,9334,3.7074435779252477
Norway,2020,18477,31,2020-08-03,5367580,372,6.930497542654232,9706,6.930497542654232
Norway,2020,18484,32,2020-08-10,5367580,369,6.874606433439278,10075,6.874606433439278
Norway,2020,18491,33,2020-08-17,5367580,359,6.6883027360561,10434,6.6883027360561
Norway,2020,18498,34,2020-08-24,5367580,377,7.0236493913458204,10811,7.0236493913458204
Norway,2020,18505,35,2020-08-31,5367580,741,13.805103976093509,11552,13.805103976093509
Norway,2020,18512,36,2020-09-07,5367580,765,14.252232849813137,12317,14.252232849813137
Norway,2020,18519,37,2020-09-14,5367580,719,13.395235841850518,13036,13.395235841850518
Norway,2020,18526,38,2020-09-21,5367580,787,14.66210098405613,13823,14.66210098405613
Norway,2020,18533,39,2020-09-28,5367580,818,15.239642445943982,14641,15.239642445943982
Norway,2020,18540,40,2020-10-05,5367580,1058,19.71093118314026,15699,19.71093118314026
Norway,2020,18547,41,2020-10-12,5367580,942,17.549808293495392,16641,17.549808293495392
Norway,2020,18554,42,2020-10-19,5367580,1709,31.839301882785165,18350,31.839301882785165
Norway,2020,18561,43,2020-10-26,5367580,3147,58.6297735664862,21497,58.6297735664862
Norway,2020,18568,44,2020-11-02,5367580,4044,75.3412152217573,25541,75.3412152217573
Norway,2020,18575,45,2020-11-09,5367580,4089,76.1795818599816,29630,76.1795818599816
Norway,2020,18582,46,2020-11-16,5367580,3657,68.13126213302829,33287,68.13126213302829
Norway,2020,18589,47,2020-11-23,5367580,2923,54.45657074510301,36210,54.45657074510301
Norway,2020,18596,48,2020-11-30,5367580,2524,47.023053219514196,38734,47.023053219514196
Norway,2020,18603,49,2020-12-07,5367580,2723,50.73049679743944,41457,50.73049679743944
Norway,2020,18610,50,2020-12-14,5367580,2947,54.903699618822635,44404,54.903699618822635
Norway,2020,18617,51,2020-12-21,5367580,3242,60.39965869162639,47646,60.39965869162639
Norway,2020,18624,52,2020-12-28,5367580,3863,71.96911829912176,51509,71.96911829912176
Norway,2021,18631,0,2021-01-04,5367580,4678,87.15286963585079,56187,87.15286963585079
Norway,2021,18631,1,2021-01-04,5367580,3006,56.00289143338339,59193,56.00289143338339
Norway,2021,18638,2,2021-01-11,5367580,2219,41.34079044932726,61412,41.34079044932726
Norway,2021,18645,3,2021-01-18,5367580,1944,36.217438771289856,63356,36.217438771289856
Norway,2021,18652,4,2021-01-25,5367580,1844,34.354401797458074,65200,34.354401797458074
Norway,2021,18659,5,2021-02-01,5367580,1734,32.30506112624311,66934,32.30506112624311
Norway,2021,18666,6,2021-02-08,5367580,2033,37.87554167800014,68967,37.87554167800014
Norway,2021,18673,7,2021-02-15,5367580,3108,57.90318914669181,72075,57.90318914669181
Norway,2021,18680,8,2021-02-22,5367580,4190,78.0612492035517,76265,78.0612492035517
Norway,2021,18687,9,2021-03-01,5367580,5662,105.48515345835554,81927,105.48515345835554
Norway,2021,18694,10,2021-03-08,5367580,6575,122.4946810294397,88502,122.4946810294397
Norway,2021,18701,11,2021-03-15,5367580,5919,110.27315848110321,94421,110.27315848110321
Norway,2021,18708,12,2021-03-22,5367580,5107,95.14529825358915,99528,95.14529825358915
Norway,2021,18715,13,2021-03-29,5367580,4823,89.85427324790687,104351,89.85427324790687
Norway,2021,18722,14,2021-04-05,5367580,3737,69.62169171209372,108088,69.62169171209372
Norway,2021,18729,15,2021-04-12,5367580,3221,60.00842092712172,111309,60.00842092712172
Norway,2021,18736,16,2021-04-19,5367580,2804,52.23955674624319,114113,52.23955674624319
Norway,2021,18743,17,2021-04-26,5367580,3119,58.1081232138133,117232,58.1081232138133
Norway,2021,18750,18,2021-05-03,5367580,2561,47.71237689983195,119793,47.71237689983195
Norway,2021,18757,19,2021-05-10,5367580,3227,60.12020314555163,123020,60.12020314555163
Norway,2021,18764,20,2021-05-17,5367580,2288,42.626285961271186,125308,42.626285961271186
Norway,2021,18771,21,2021-05-24,5367580,1863,34.70837882248611,127171,34.70837882248611
Norway,2021,18778,22,2021-05-31,5367580,1221,22.747681450486066,128392,22.747681450486066
Norway,2021,18785,23,2021-06-07,5367580,1254,23.362483651850553,129646,23.362483651850553
Norway,2021,18792,24,2021-06-14,5367580,1270,23.66056956766364,130916,23.66056956766364
Norway,2021,18799,25,2021-06-21,5367580,1305,24.312632508504763,132221,24.312632508504763
Norway,2021,18806,26,2021-06-28,5367580,1178,21.9465755517384,133399,21.9465755517384
Norway,2021,18813,27,2021-07-05,5367580,1183,22.03972740042999,134582,22.03972740042999
Norway,2021,18820,28,2021-07-12,5367580,1502,27.982815346953377,136084,27.982815346953377
Norway,2021,18827,29,2021-07-19,5367580,2277,42.421351894149694,138361,42.421351894149694
Norway,2021,18834,30,2021-07-26,5367580,2995,55.79795736626189,141356,55.79795736626189
Norway,2021,18841,31,2021-08-02,5367580,3746,69.78936503973858,145102,69.78936503973858
Norway,2021,18848,32,2021-08-09,5367580,4506,83.94844604086013,149608,83.94844604086013
Norway,2021,18855,33,2021-08-16,5367580,8711,162.2891507904866,158319,162.2891507904866
Norway,2021,18862,34,2021-08-23,5367580,10104,188.24125583596333,168423,188.24125583596333
Norway,2021,18869,35,2021-08-30,5367580,8551,159.30829163235575,176974,159.30829163235575
Norway,2021,18876,36,2021-09-06,5367580,5727,106.69612749134619,182701,106.69612749134619
Norway,2021,18883,37,2021-09-13,5367580,4615,85.97915634233676,187316,85.97915634233676
Norway,2021,18890,38,2021-09-20,5367580,3480,64.83368668934604,190796,64.83368668934604
Norway,2021,18897,39,2021-09-27,5367580,3010,56.077412912336655,193806,56.077412912336655
Norway,2021,18904,40,2021-10-04,5367580,2830,52.72394635943945,196636,52.72394635943945
Norway,2021,18911,41,2021-10-11,5367580,4398,81.9363661091218,201034,81.9363661091218
Norway,2021,18918,42,2021-10-18,5367580,6999,130.39395779848647,208033,130.39395779848647
Norway,2021,18925,43,2021-10-25,5367580,9831,183.15516489740256,217864,183.15516489740256
Poland,2020,18267,0,2020-01-06,37958138,0,0,0,0
Poland,2020,18267,1,2020-01-06,37958138,0,0,0,0
Poland,2020,18274,2,2020-01-13,37958138,0,0,0,0
Poland,2020,18281,3,2020-01-20,37958138,0,0,0,0
Poland,2020,18288,4,2020-01-27,37958138,0,0,0,0
Poland,2020,18295,5,2020-02-03,37958138,0,0,0,0
Poland,2020,18302,6,2020-02-10,37958138,0,0,0,0
Poland,2020,18309,7,2020-02-17,37958138,0,0,0,0
Poland,2020,18316,8,2020-02-24,37958138,0,0,0,0
Poland,2020,18323,9,2020-03-02,37958138,11,0.02897929292527468,11,0.02897929292527468
Poland,2020,18330,10,2020-03-09,37958138,114,0.3003308539528467,125,0.3003308539528467
Poland,2020,18337,11,2020-03-16,37958138,509,1.3409509180877102,634,1.3409509180877102
Poland,2020,18344,12,2020-03-23,37958138,1228,3.2351428829306643,1862,3.2351428829306643
Poland,2020,18351,13,2020-03-30,37958138,2240,5.901237832055934,4102,5.901237832055934
Poland,2020,18358,14,2020-04-06,37958138,2572,6.775885582164225,6674,6.775885582164225
Poland,2020,18365,15,2020-04-13,37958138,2550,6.717926996313676,9224,6.717926996313676
Poland,2020,18372,16,2020-04-20,37958138,2330,6.138341137808182,11554,6.138341137808182
Poland,2020,18379,17,2020-04-27,37958138,2139,5.635155233378413,13693,5.635155233378413
Poland,2020,18386,18,2020-05-04,37958138,2303,6.067210146082508,15996,6.067210146082508
Poland,2020,18393,19,2020-05-11,37958138,2533,6.673140816338251,18529,6.673140816338251
Poland,2020,18400,20,2020-05-18,37958138,2759,7.268533561893895,21288,7.268533561893895
Poland,2020,18407,21,2020-05-25,37958138,2496,6.575665012862327,23784,6.575665012862327
Poland,2020,18414,22,2020-06-01,37958138,2777,7.315954223044344,26561,7.315954223044344
Poland,2020,18421,23,2020-06-08,37958138,2831,7.458216206495693,29392,7.458216206495693
Poland,2020,18428,24,2020-06-15,37958138,2539,6.6889477033884015,31931,6.6889477033884015
Poland,2020,18435,25,2020-06-22,37958138,1976,5.205734801849342,33907,5.205734801849342
Poland,2020,18442,26,2020-06-29,37958138,2043,5.382245040576016,35950,5.382245040576016
Poland,2020,18449,27,2020-07-06,37958138,1941,5.113527960723468,37891,5.113527960723468
Poland,2020,18456,28,2020-07-13,37958138,2213,5.83010684033026,40104,5.83010684033026
Poland,2020,18463,29,2020-07-20,37958138,2961,7.800698759248939,43065,7.800698759248939
Poland,2020,18470,30,2020-07-27,37958138,3829,10.087428419170614,46894,10.087428419170614
Poland,2020,18477,31,2020-08-03,37958138,4897,12.901054314097282,51791,12.901054314097282
Poland,2020,18484,32,2020-08-10,37958138,4893,12.890516389397183,56684,12.890516389397183
Poland,2020,18491,33,2020-08-17,37958138,5078,13.377895406776803,61762,13.377895406776803
Poland,2020,18498,34,2020-08-24,37958138,5108,13.456929842027552,66870,13.456929842027552
Poland,2020,18505,35,2020-08-31,37958138,3954,10.416738566048735,70824,10.416738566048735
Poland,2020,18512,36,2020-09-07,37958138,3328,8.767553350483103,74152,8.767553350483103
Poland,2020,18519,37,2020-09-14,37958138,5088,13.404240218527052,79240,13.404240218527052
Poland,2020,18526,38,2020-09-21,37958138,8090,21.312952705952014,87330,21.312952705952014
Poland,2020,18533,39,2020-09-28,37958138,12744,33.57382809451823,100074,33.57382809451823
Poland,2020,18540,40,2020-10-05,37958138,25742,67.8168144074928,125816,67.8168144074928
Poland,2020,18547,41,2020-10-12,37958138,49950,131.5923346924973,175766,131.5923346924973
Poland,2020,18554,42,2020-10-19,37958138,77922,205.2840421202958,253688,205.2840421202958
Poland,2020,18561,43,2020-10-26,37958138,126214,332.5084070246017,379902,332.5084070246017
Poland,2020,18568,44,2020-11-02,37958138,166613,438.9388120144355,546515,438.9388120144355
Poland,2020,18575,45,2020-11-09,37958138,166547,438.76493625688386,713062,438.76493625688386
Poland,2020,18582,46,2020-11-16,37958138,148359,390.8489926455297,861421,390.8489926455297
Poland,2020,18589,47,2020-11-23,37958138,100911,265.84812985294485,962332,265.84812985294485
Poland,2020,18596,48,2020-11-30,37958138,77033,202.94198835569858,1039365,202.94198835569858
Poland,2020,18603,49,2020-12-07,37958138,72664,191.4319401020145,1112029,191.4319401020145
Poland,2020,18610,50,2020-12-14,37958138,66790,175.9569976799178,1178819,175.9569976799178
Poland,2020,18617,51,2020-12-21,37958138,53668,141.38733570124015,1232487,141.38733570124015
Poland,2020,18624,52,2020-12-28,37958138,62386,164.35474258510783,1294873,164.35474258510783
Poland,2021,18631,0,2021-01-04,37958138,67219,177.08719010400353,1362092,177.08719010400353
Poland,2021,18631,1,2021-01-04,37958138,48578,127.97782652036304,1410670,127.97782652036304
Poland,2021,18638,2,2021-01-11,37958138,38948,102.60777280487257,1449618,102.60777280487257
Poland,2021,18645,3,2021-01-18,37958138,37763,99.48591261246797,1487381,99.48591261246797
Poland,2021,18652,4,2021-01-25,37958138,36794,96.93310035386878,1524175,96.93310035386878
Poland,2021,18659,5,2021-02-01,37958138,38814,102.25475232741923,1562989,102.25475232741923
Poland,2021,18666,6,2021-02-08,37958138,51154,134.76425002722738,1614143,134.76425002722738
Poland,2021,18673,7,2021-02-15,37958138,69123,182.10324226125107,1683266,182.10324226125107
Poland,2021,18680,8,2021-02-22,37958138,89419,235.57267218955786,1772685,235.57267218955786
Poland,2021,18687,9,2021-03-01,37958138,117089,308.4687663024988,1889774,308.4687663024988
Poland,2021,18694,10,2021-03-08,37958138,155552,409.7988157374843,2045326,409.7988157374843
Poland,2021,18701,11,2021-03-15,37958138,194006,511.1051548418945,2239332,511.1051548418945
Poland,2021,18708,12,2021-03-22,37958138,180514,475.5607348284576,2419846,475.5607348284576
Poland,2021,18715,13,2021-03-29,37958138,138144,363.9377674426496,2557990,363.9377674426496
Poland,2021,18722,14,2021-04-05,37958138,108715,286.40762094283974,2666705,286.40762094283974
Poland,2021,18729,15,2021-04-12,37958138,67003,176.51814217019813,2733708,176.51814217019813
Poland,2021,18736,16,2021-04-19,37958138,43437,114.43395879955966,2777145,114.43395879955966
Poland,2021,18743,17,2021-04-26,37958138,29332,77.27460182583245,2806477,77.27460182583245
Poland,2021,18750,18,2021-05-03,37958138,20539,54.10960885383788,2827016,54.10960885383788
Poland,2021,18757,19,2021-05-10,37958138,10998,28.97402396292463,2838014,28.97402396292463
Poland,2021,18764,20,2021-05-17,37958138,6122,16.128293753502874,2844136,16.128293753502874
Poland,2021,18771,21,2021-05-24,37958138,3056,8.05097447087631,2847192,8.05097447087631
Poland,2021,18778,22,2021-05-31,37958138,2140,5.6377897145534375,2849332,5.6377897145534375
Poland,2021,18785,23,2021-06-07,37958138,1224,3.2246049582305645,2850556,3.2246049582305645
Poland,2021,18792,24,2021-06-14,37958138,846,2.2287710740711253,2851402,2.2287710740711253
Poland,2021,18799,25,2021-06-21,37958138,619,1.630743847340457,2852021,1.630743847340457
Poland,2021,18806,26,2021-06-28,37958138,560,1.4753094580139836,2852581,1.4753094580139836
Poland,2021,18813,27,2021-07-05,37958138,629,1.6570886590907068,2853210,1.6570886590907068
Poland,2021,18820,28,2021-07-12,37958138,738,1.9442471071684286,2853948,1.9442471071684286
Poland,2021,18827,29,2021-07-19,37958138,896,2.3604951328223738,2854844,2.3604951328223738
Poland,2021,18834,30,2021-07-26,37958138,1042,2.74512938437602,2855886,2.74512938437602
Poland,2021,18841,31,2021-08-02,37958138,1301,3.427460008707487,2857187,3.427460008707487
Poland,2021,18848,32,2021-08-09,37958138,1350,3.556549586283711,2858537,3.556549586283711
Poland,2021,18855,33,2021-08-16,37958138,1612,4.246783654140253,2860149,4.246783654140253
Poland,2021,18862,34,2021-08-23,37958138,2283,6.014520522582009,2862432,6.014520522582009
Poland,2021,18869,35,2021-08-30,37958138,3251,8.56469830000618,2865683,8.56469830000618
Poland,2021,18876,36,2021-09-06,37958138,4380,11.539027546609372,2870063,11.539027546609372
Poland,2021,18883,37,2021-09-13,37958138,5358,14.115550135783794,2875421,14.115550135783794
Poland,2021,18890,38,2021-09-20,37958138,7896,20.80186335799717,2883317,20.80186335799717
Poland,2021,18897,39,2021-09-27,37958138,11756,30.970960693593558,2895073,30.970960693593558
Poland,2021,18904,40,2021-10-04,37958138,17820,46.946454538944984,2912893,46.946454538944984
Poland,2021,18911,41,2021-10-11,37958138,34756,91.5640277191679,2947649,91.5640277191679
Poland,2021,18918,42,2021-10-18,37958138,54275,142.9864657744803,3001924,142.9864657744803
Poland,2021,18925,43,2021-10-25,37958138,81382,214.39934698588218,3083306,214.39934698588218
Portugal,2020,18267,0,2020-01-06,10295909,0,0,0,0
Portugal,2020,18267,1,2020-01-06,10295909,0,0,0,0
Portugal,2020,18274,2,2020-01-13,10295909,0,0,0,0
Portugal,2020,18281,3,2020-01-20,10295909,0,0,0,0
Portugal,2020,18288,4,2020-01-27,10295909,0,0,0,0
Portugal,2020,18295,5,2020-02-03,10295909,0,0,0,0
Portugal,2020,18302,6,2020-02-10,10295909,0,0,0,0
Portugal,2020,18309,7,2020-02-17,10295909,1,0.009712595556157305,1,0.009712595556157305
Portugal,2020,18316,8,2020-02-24,10295909,1,0.009712595556157305,2,0.009712595556157305
Portugal,2020,18323,9,2020-03-02,10295909,29,0.2816652711285618,31,0.2816652711285618
Portugal,2020,18330,10,2020-03-09,10295909,342,3.3217076802057983,373,3.3217076802057983
Portugal,2020,18337,11,2020-03-16,10295909,1702,16.530837636579733,2075,16.530837636579733
Portugal,2020,18344,12,2020-03-23,10295909,4706,45.707474687276274,6781,45.707474687276274
Portugal,2020,18351,13,2020-03-30,10295909,5798,56.313629034600055,12579,56.313629034600055
Portugal,2020,18358,14,2020-04-06,10295909,4936,47.941371665192456,17515,47.941371665192456
Portugal,2020,18365,15,2020-04-13,10295909,4259,41.36594447367396,21774,41.36594447367396
Portugal,2020,18372,16,2020-04-20,10295909,2977,28.914396970680297,24751,28.914396970680297
Portugal,2020,18379,17,2020-04-27,10295909,2147,20.852942659069733,26898,20.852942659069733
Portugal,2020,18386,18,2020-05-04,10295909,2021,19.629155618993913,28919,19.629155618993913
Portugal,2020,18393,19,2020-05-11,10295909,1714,16.64738878325362,30633,16.64738878325362
Portugal,2020,18400,20,2020-05-18,10295909,1772,17.210719325510745,32405,17.210719325510745
Portugal,2020,18407,21,2020-05-25,10295909,2049,19.901108294566317,34454,19.901108294566317
Portugal,2020,18414,22,2020-06-01,10295909,2270,22.04759191247708,36724,22.04759191247708
Portugal,2020,18421,23,2020-06-08,10295909,2061,20.017659441240205,38785,20.017659441240205
Portugal,2020,18428,24,2020-06-15,10295909,2506,24.339764463730205,41291,24.339764463730205
Portugal,2020,18435,25,2020-06-22,10295909,2718,26.398834721635556,44009,26.398834721635556
Portugal,2020,18442,26,2020-06-29,10295909,2558,24.844819432650386,46567,24.844819432650386
Portugal,2020,18449,27,2020-07-06,10295909,2512,24.39804003706715,49079,24.39804003706715
Portugal,2020,18456,28,2020-07-13,10295909,1962,19.056112481180634,51041,19.056112481180634
Portugal,2020,18463,29,2020-07-20,10295909,1586,15.404176552065486,52627,15.404176552065486
Portugal,2020,18470,30,2020-07-27,10295909,1344,13.053728427475418,53971,13.053728427475418
Portugal,2020,18477,31,2020-08-03,10295909,1339,13.005165449694632,55310,13.005165449694632
Portugal,2020,18484,32,2020-08-10,10295909,1452,14.102688747540407,56762,14.102688747540407
Portugal,2020,18491,33,2020-08-17,10295909,1505,14.617456312016744,58267,14.617456312016744
Portugal,2020,18498,34,2020-08-24,10295909,2372,23.038276659205128,60639,23.038276659205128
Portugal,2020,18505,35,2020-08-31,10295909,2685,26.078319068282365,63324,26.078319068282365
Portugal,2020,18512,36,2020-09-07,10295909,4218,40.96772805587151,67542,40.96772805587151
Portugal,2020,18519,37,2020-09-14,10295909,4795,46.57189569177427,72337,46.57189569177427
Portugal,2020,18526,38,2020-09-21,10295909,5024,48.7960800741343,77361,48.7960800741343
Portugal,2020,18533,39,2020-09-28,10295909,5900,57.3043137813281,83261,57.3043137813281
Portugal,2020,18540,40,2020-10-05,10295909,8419,81.77034198728835,91680,81.77034198728835
Portugal,2020,18547,41,2020-10-12,10295909,14359,139.46315959086274,106039,139.46315959086274
Portugal,2020,18554,42,2020-10-19,10295909,19776,192.07628971856687,125815,192.07628971856687
Portugal,2020,18561,43,2020-10-26,10295909,26231,254.77109403356226,152046,254.77109403356226
Portugal,2020,18568,44,2020-11-02,10295909,36781,357.23897715102186,188827,357.23897715102186
Portugal,2020,18575,45,2020-11-09,10295909,38102,370.06931588070563,226929,370.06931588070563
Portugal,2020,18582,46,2020-11-16,10295909,39338,382.07408398811606,266267,382.07408398811606
Portugal,2020,18589,47,2020-11-23,10295909,33296,323.3905816378136,299563,323.3905816378136
Portugal,2020,18596,48,2020-11-30,10295909,26387,256.2862589403228,325950,256.2862589403228
Portugal,2020,18603,49,2020-12-07,10295909,25662,249.24462716210874,351612,249.24462716210874
Portugal,2020,18610,50,2020-12-14,10295909,25255,245.29160077075272,376867,245.29160077075272
Portugal,2020,18617,51,2020-12-21,10295909,20441,198.53516576341147,397308,198.53516576341147
Portugal,2020,18624,52,2020-12-28,10295909,35065,340.5721631766559,432373,340.5721631766559
Portugal,2021,18631,0,2021-01-04,10295909,57493,558.4062563101519,489866,558.4062563101519
Portugal,2021,18631,1,2021-01-04,10295909,67279,653.4537164227073,557145,653.4537164227073
Portugal,2021,18638,2,2021-01-11,10295909,86677,841.8586450210468,643822,841.8586450210468
Portugal,2021,18645,3,2021-01-18,10295909,82572,801.988440263021,726394,801.988440263021
Portugal,2021,18652,4,2021-01-25,10295909,41505,403.1212785583089,767899,403.1212785583089
Portugal,2021,18659,5,2021-02-01,10295909,19163,186.12246864264245,787062,186.12246864264245
Portugal,2021,18666,6,2021-02-08,10295909,10950,106.35292133992249,798012,106.35292133992249
Portugal,2021,18673,7,2021-02-15,10295909,6870,66.72553147080069,804882,66.72553147080069
Portugal,2021,18680,8,2021-02-22,10295909,5512,53.535826705539066,810394,53.535826705539066
Portugal,2021,18687,9,2021-03-01,10295909,4042,39.258311237987826,814436,39.258311237987826
Portugal,2021,18694,10,2021-03-08,10295909,3260,31.663061513072815,817696,31.663061513072815
Portugal,2021,18701,11,2021-03-15,10295909,3092,30.031345459638388,820788,30.031345459638388
Portugal,2021,18708,12,2021-03-22,10295909,3234,31.410534028612723,824022,31.410534028612723
Portugal,2021,18715,13,2021-03-29,10295909,3826,37.16039059785785,827848,37.16039059785785
Portugal,2021,18722,14,2021-04-05,10295909,3510,34.09121040211214,831358,34.09121040211214
Portugal,2021,18729,15,2021-04-12,10295909,3370,32.731447024250116,834728,32.731447024250116
Portugal,2021,18736,16,2021-04-19,10295909,2861,27.78773588616605,837589,27.78773588616605
Portugal,2021,18743,17,2021-04-26,10295909,2382,23.1354026147667,839971,23.1354026147667
Portugal,2021,18750,18,2021-05-03,10295909,2636,25.602401886030655,842607,25.602401886030655
Portugal,2021,18757,19,2021-05-10,10295909,3120,30.30329813521079,845727,30.30329813521079
Portugal,2021,18764,20,2021-05-17,10295909,3600,34.9653440021663,849327,34.9653440021663
Portugal,2021,18771,21,2021-05-24,10295909,3939,38.257913895703624,853266,38.257913895703624
Portugal,2021,18778,22,2021-05-31,10295909,5069,49.23314687416138,858335,49.23314687416138
Portugal,2021,18785,23,2021-06-07,10295909,7733,75.10750143576443,866068,75.10750143576443
Portugal,2021,18792,24,2021-06-14,10295909,9663,93.85281085914804,875731,93.85281085914804
Portugal,2021,18799,25,2021-06-21,10295909,15113,146.78645664020536,890844,146.78645664020536
Portugal,2021,18806,26,2021-06-28,10295909,19170,186.19045681153554,910014,186.19045681153554
Portugal,2021,18813,27,2021-07-05,10295909,22798,221.42775348927424,932812,221.42775348927424
Portugal,2021,18820,28,2021-07-12,10295909,22094,214.5900862177395,954906,214.5900862177395
Portugal,2021,18827,29,2021-07-19,10295909,17452,169.50421764605727,972358,169.50421764605727
Portugal,2021,18834,30,2021-07-26,10295909,15934,154.7604975918105,988292,154.7604975918105
Portugal,2021,18841,31,2021-08-02,10295909,16412,159.4031182676537,1004704,159.4031182676537
Portugal,2021,18848,32,2021-08-09,10295909,16050,155.88715867632473,1020754,155.88715867632473
Portugal,2021,18855,33,2021-08-16,10295909,15420,149.76822347594563,1036174,149.76822347594563
Portugal,2021,18862,34,2021-08-23,10295909,11785,114.46293862931384,1047959,114.46293862931384
Portugal,2021,18869,35,2021-08-30,10295909,8308,80.69224388055488,1056267,80.69224388055488
Portugal,2021,18876,36,2021-09-06,10295909,6305,61.237914981571805,1062572,61.237914981571805
Portugal,2021,18883,37,2021-09-13,10295909,4954,48.11619838520329,1067526,48.11619838520329
Portugal,2021,18890,38,2021-09-20,10295909,4155,40.3558345358336,1071681,40.3558345358336
Portugal,2021,18897,39,2021-09-27,10295909,4259,41.36594447367396,1075940,41.36594447367396
Portugal,2021,18904,40,2021-10-04,10295909,4411,42.84225899820987,1080351,42.84225899820987
Portugal,2021,18911,41,2021-10-11,10295909,5231,50.80658735425886,1085582,50.80658735425886
Portugal,2021,18918,42,2021-10-18,10295909,5687,55.23553092786659,1091269,55.23553092786659
Portugal,2021,18925,43,2021-10-25,10295909,6943,67.43455094640017,1098212,67.43455094640017
Romania,2020,18267,0,2020-01-06,19328838,0,0,0,0
Romania,2020,18267,1,2020-01-06,19328838,0,0,0,0
Romania,2020,18274,2,2020-01-13,19328838,0,0,0,0
Romania,2020,18281,3,2020-01-20,19328838,0,0,0,0
Romania,2020,18288,4,2020-01-27,19328838,0,0,0,0
Romania,2020,18295,5,2020-02-03,19328838,0,0,0,0
Romania,2020,18302,6,2020-02-10,19328838,0,0,0,0
Romania,2020,18309,7,2020-02-17,19328838,0,0,0,0
Romania,2020,18316,8,2020-02-24,19328838,3,0.01552085024459308,3,0.01552085024459308
Romania,2020,18323,9,2020-03-02,19328838,12,0.06208340097837232,15,0.06208340097837232
Romania,2020,18330,10,2020-03-09,19328838,143,0.7398271949922701,158,0.7398271949922701
Romania,2020,18337,11,2020-03-16,19328838,372,1.9245854303295418,530,1.9245854303295418
Romania,2020,18344,12,2020-03-23,19328838,1376,7.118896645520025,1906,7.118896645520025
Romania,2020,18351,13,2020-03-30,19328838,2134,11.040498140653877,4040,11.040498140653877
Romania,2020,18358,14,2020-04-06,19328838,2491,12.887479319760454,6531,12.887479319760454
Romania,2020,18365,15,2020-04-13,19328838,2287,11.832061503128124,8818,11.832061503128124
Romania,2020,18372,16,2020-04-20,19328838,2495,12.908173786753244,11313,12.908173786753244
Romania,2020,18379,17,2020-04-27,19328838,2084,10.781817303243992,13397,10.781817303243992
Romania,2020,18386,18,2020-05-04,19328838,3130,16.19342042185878,16527,16.19342042185878
Romania,2020,18393,19,2020-05-11,19328838,804,4.159587865550945,17331,4.159587865550945
Romania,2020,18400,20,2020-05-18,19328838,1383,7.15511196275741,18714,7.15511196275741
Romania,2020,18407,21,2020-05-25,19328838,1047,5.416776735362984,19761,5.416776735362984
Romania,2020,18414,22,2020-06-01,19328838,1204,6.229034564830022,20965,6.229034564830022
Romania,2020,18421,23,2020-06-08,19328838,1416,7.325841315447933,22381,7.325841315447933
Romania,2020,18428,24,2020-06-15,19328838,2017,10.435184981114746,24398,10.435184981114746
Romania,2020,18435,25,2020-06-22,19328838,2172,11.23709557708539,26570,11.23709557708539
Romania,2020,18442,26,2020-06-29,19328838,1850,9.571190984165732,28420,9.571190984165732
Romania,2020,18449,27,2020-07-06,19328838,3747,19.385541955496755,32167,19.385541955496755
Romania,2020,18456,28,2020-07-13,19328838,5230,27.058015593073936,37397,27.058015593073936
Romania,2020,18463,29,2020-07-20,19328838,7507,38.83834092872008,44904,38.83834092872008
Romania,2020,18470,30,2020-07-27,19328838,7447,38.52792392382822,52351,38.52792392382822
Romania,2020,18477,31,2020-08-03,19328838,7714,39.909279595597006,60065,39.909279595597006
Romania,2020,18484,32,2020-08-10,19328838,4422,22.8777332605302,64487,22.8777332605302
Romania,2020,18491,33,2020-08-17,19328838,7716,39.919626829093396,72203,39.919626829093396
Romania,2020,18498,34,2020-08-24,19328838,8280,42.8375466750769,80483,42.8375466750769
Romania,2020,18505,35,2020-08-31,19328838,8229,42.573692220918815,88712,42.573692220918815
Romania,2020,18512,36,2020-09-07,19328838,8481,43.87744364146464,97193,43.87744364146464
Romania,2020,18519,37,2020-09-14,19328838,9286,48.04220512376378,106479,48.04220512376378
Romania,2020,18526,38,2020-09-21,19328838,9887,51.15154878943059,116366,51.15154878943059
Romania,2020,18533,39,2020-09-28,19328838,13227,68.43142872841088,129593,68.43142872841088
Romania,2020,18540,40,2020-10-05,19328838,19383,100.28021343031588,148976,100.28021343031588
Romania,2020,18547,41,2020-10-12,19328838,25105,129.88364846350308,174081,129.88364846350308
Romania,2020,18554,42,2020-10-19,19328838,29260,151.3800260522645,203341,151.3800260522645
Romania,2020,18561,43,2020-10-26,19328838,37011,191.48072946754482,240352,191.48072946754482
Romania,2020,18568,44,2020-11-02,19328838,57088,295.3514329211099,297440,295.3514329211099
Romania,2020,18575,45,2020-11-09,19328838,56530,292.46455477561557,353970,292.46455477561557
Romania,2020,18582,46,2020-11-16,19328838,58364,301.95296789181015,412334,301.95296789181015
Romania,2020,18589,47,2020-11-23,19328838,52510,271.66661544786086,464844,271.66661544786086
Romania,2020,18596,48,2020-11-30,19328838,41874,216.6400277140302,506718,216.6400277140302
Romania,2020,18603,49,2020-12-07,19328838,42351,219.1078429029205,549069,219.1078429029205
Romania,2020,18610,50,2020-12-14,19328838,34196,176.9169983213683,583265,176.9169983213683
Romania,2020,18617,51,2020-12-21,19328838,24646,127.50895837608034,607911,127.50895837608034
Romania,2020,18624,52,2020-12-28,19328838,25130,130.01298888220802,633041,130.01298888220802
Romania,2021,18631,0,2021-01-04,19328838,29409,152.15089494774594,662450,152.15089494774594
Romania,2021,18631,1,2021-01-04,19328838,20757,107.38876284233952,683207,107.38876284233952
Romania,2021,18638,2,2021-01-11,19328838,17383,89.93297993392049,700590,89.93297993392049
Romania,2021,18645,3,2021-01-18,19328838,17240,89.19315273892823,717830,89.19315273892823
Romania,2021,18652,4,2021-01-25,19328838,16659,86.18728140822537,734489,86.18728140822537
Romania,2021,18659,5,2021-02-01,19328838,16498,85.35432911176554,750987,85.35432911176554
Romania,2021,18666,6,2021-02-08,19328838,18404,95.21524263383034,769391,95.21524263383034
Romania,2021,18673,7,2021-02-15,19328838,23068,119.34499114742438,792459,119.34499114742438
Romania,2021,18680,8,2021-02-22,19328838,27212,140.78445895195563,819671,140.78445895195563
Romania,2021,18687,9,2021-03-01,19328838,32564,168.47365578830969,852235,168.47365578830969
Romania,2021,18694,10,2021-03-08,19328838,38123,197.23379129154065,890358,197.23379129154065
Romania,2021,18701,11,2021-03-15,19328838,39497,204.34234070356428,929855,204.34234070356428
Romania,2021,18708,12,2021-03-22,19328838,37268,192.81034897183162,967123,192.81034897183162
Romania,2021,18715,13,2021-03-29,19328838,30084,155.6430862527794,997207,155.6430862527794
Romania,2021,18722,14,2021-04-05,19328838,22125,114.46627055387395,1019332,114.46627055387395
Romania,2021,18729,15,2021-04-12,19328838,16108,83.33661857996844,1035440,83.33661857996844
Romania,2021,18736,16,2021-04-19,19328838,10403,53.8211350315006,1045843,53.8211350315006
Romania,2021,18743,17,2021-04-26,19328838,8313,43.00827602776742,1054156,43.00827602776742
Romania,2021,18750,18,2021-05-03,19328838,5399,27.932356823519346,1059555,27.932356823519346
Romania,2021,18757,19,2021-05-10,19328838,3389,17.533387159641983,1062944,17.533387159641983
Romania,2021,18764,20,2021-05-17,19328838,1922,9.943691390035966,1064866,9.943691390035966
Romania,2021,18771,21,2021-05-24,19328838,1224,6.332506899793977,1066090,6.332506899793977
Romania,2021,18778,22,2021-05-31,19328838,841,4.35101168523426,1066931,4.35101168523426
Romania,2021,18785,23,2021-06-07,19328838,476,2.4626415721421018,1067407,2.4626415721421018
Romania,2021,18792,24,2021-06-14,19328838,393,2.033231382041693,1067800,2.033231382041693
Romania,2021,18799,25,2021-06-21,19328838,298,1.5417377909629124,1068098,1.5417377909629124
Romania,2021,18806,26,2021-06-28,19328838,305,1.5779531082002964,1068403,1.5779531082002964
Romania,2021,18813,27,2021-07-05,19328838,431,2.2298288184732056,1068834,2.2298288184732056
Romania,2021,18820,28,2021-07-12,19328838,703,3.637052573982978,1069537,3.637052573982978
Romania,2021,18827,29,2021-07-19,19328838,1141,5.903096709693568,1070678,5.903096709693568
Romania,2021,18834,30,2021-07-26,19328838,1643,8.50025231728881,1072321,8.50025231728881
Romania,2021,18841,31,2021-08-02,19328838,2535,13.115118456681152,1074856,13.115118456681152
Romania,2021,18848,32,2021-08-09,19328838,3891,20.130542767237223,1078747,20.130542767237223
Romania,2021,18855,33,2021-08-16,19328838,6313,32.66104253137203,1085060,32.66104253137203
Romania,2021,18862,34,2021-08-23,19328838,9861,51.01703475397745,1094921,51.01703475397745
Romania,2021,18869,35,2021-08-30,19328838,16538,85.56127378169344,1111459,85.56127378169344
Romania,2021,18876,36,2021-09-06,19328838,30852,159.61642391539522,1142311,159.61642391539522
Romania,2021,18883,37,2021-09-13,19328838,48137,249.04238940799235,1190448,249.04238940799235
Romania,2021,18890,38,2021-09-20,19328838,76558,396.081751008519,1267006,396.081751008519
Romania,2021,18897,39,2021-09-27,19328838,91668,474.25510007378614,1358674,474.25510007378614
Romania,2021,18904,40,2021-10-04,19328838,101269,523.9269944732322,1459943,523.9269944732322
Romania,2021,18911,41,2021-10-11,19328838,103714,536.5764874225755,1563657,536.5764874225755
Romania,2021,18918,42,2021-10-18,19328838,83909,434.11300772452023,1647566,434.11300772452023
Romania,2021,18925,43,2021-10-25,19328838,56113,290.3071565916172,1703679,290.3071565916172
Russia,2020,18267,0,2020-01-06,145934460,0,0,0,0
Russia,2020,18267,1,2020-01-06,145934460,0,0,0,0
Russia,2020,18274,2,2020-01-13,145934460,0,0,0,0
Russia,2020,18281,3,2020-01-20,145934460,0,0,0,0
Russia,2020,18288,4,2020-01-27,145934460,2,0.001370478227006836,2,0.001370478227006836
Russia,2020,18295,5,2020-02-03,145934460,0,0,2,0
Russia,2020,18302,6,2020-02-10,145934460,0,0,2,0
Russia,2020,18309,7,2020-02-17,145934460,0,0,2,0
Russia,2020,18316,8,2020-02-24,145934460,0,0,2,0
Russia,2020,18323,9,2020-03-02,145934460,8,0.005481912908027344,10,0.005481912908027344
Russia,2020,18330,10,2020-03-09,145934460,53,0.036317673015681146,63,0.036317673015681146
Russia,2020,18337,11,2020-03-16,145934460,304,0.20831269050503903,367,0.20831269050503903
Russia,2020,18344,12,2020-03-23,145934460,1167,0.7996740454584887,1534,0.7996740454584887
Russia,2020,18351,13,2020-03-30,145934460,3855,2.641596782555676,5389,2.641596782555676
Russia,2020,18358,14,2020-04-06,145934460,10381,7.113467237278981,15770,7.113467237278981
Russia,2020,18365,15,2020-04-13,145934460,27083,18.558330911013066,42853,18.558330911013066
Russia,2020,18372,16,2020-04-20,145934460,38096,26.10486926802621,80949,26.10486926802621
Russia,2020,18379,17,2020-04-27,145934460,53738,36.82337948144667,134687,36.82337948144667
Russia,2020,18386,18,2020-05-04,145934460,75001,51.393618751869845,209688,51.393618751869845
Russia,2020,18393,19,2020-05-11,145934460,72064,49.38107147551031,281752,49.38107147551031
Russia,2020,18400,20,2020-05-18,145934460,62729,42.9843643509559,344481,42.9843643509559
Russia,2020,18407,21,2020-05-25,145934460,61362,42.04764248279673,405843,42.04764248279673
Russia,2020,18414,22,2020-06-01,145934460,61830,42.36833438791633,467673,42.36833438791633
Russia,2020,18421,23,2020-06-08,145934460,61291,41.998990505737986,528964,41.998990505737986
Russia,2020,18428,24,2020-06-15,145934460,55716,38.17878244795643,584680,38.17878244795643
Russia,2020,18435,25,2020-06-22,145934460,49757,34.09544257058956,634437,34.09544257058956
Russia,2020,18442,26,2020-06-29,145934460,46814,32.078783859549006,681251,32.078783859549006
Russia,2020,18449,27,2020-07-06,145934460,45911,31.46001294005542,727162,31.46001294005542
Russia,2020,18456,28,2020-07-13,145934460,44384,30.413652813735702,771546,30.413652813735702
Russia,2020,18463,29,2020-07-20,145934460,40939,28.053004067716426,812485,28.053004067716426
Russia,2020,18470,30,2020-07-27,145934460,38385,26.302903371828695,850870,26.302903371828695
Russia,2020,18477,31,2020-08-03,145934460,36666,25.12497733571632,887536,25.12497733571632
Russia,2020,18484,32,2020-08-10,145934460,35317,24.20058977160021,922853,24.20058977160021
Russia,2020,18491,33,2020-08-17,145934460,33896,23.226864991311853,956749,23.226864991311853
Russia,2020,18498,34,2020-08-24,145934460,33577,23.008273714104263,990326,23.008273714104263
Russia,2020,18505,35,2020-08-31,145934460,35179,24.106026773936737,1025505,24.106026773936737
Russia,2020,18512,36,2020-09-07,145934460,37306,25.56353036835851,1062811,25.56353036835851
Russia,2020,18519,37,2020-09-14,145934460,40588,27.812485138876728,1103399,27.812485138876728
Russia,2020,18526,38,2020-09-21,145934460,48039,32.918201773590695,1151438,32.918201773590695
Russia,2020,18533,39,2020-09-28,145934460,63563,43.555853771617755,1215001,43.555853771617755
Russia,2020,18540,40,2020-10-05,145934460,83717,57.366162865165634,1298718,57.366162865165634
Russia,2020,18547,41,2020-10-12,145934460,100616,68.9460186442599,1399334,68.9460186442599
Russia,2020,18554,42,2020-10-19,145934460,114543,78.489343778022,1513877,78.489343778022
Russia,2020,18561,43,2020-10-26,145934460,122904,84.21862800602408,1636781,84.21862800602408
Russia,2020,18568,44,2020-11-02,145934460,137553,94.25669577973564,1774334,94.25669577973564
Russia,2020,18575,45,2020-11-09,145934460,151491,103.80755854374628,1925825,103.80755854374628
Russia,2020,18582,46,2020-11-16,145934460,163504,112.03933601426284,2089329,112.03933601426284
Russia,2020,18589,47,2020-11-23,145934460,179987,123.33413232213968,2269316,123.33413232213968
Russia,2020,18596,48,2020-11-30,145934460,191454,131.19176923668337,2460770,131.19176923668337
Russia,2020,18603,49,2020-12-07,145934460,193158,132.3594166860932,2653928,132.3594166860932
Russia,2020,18610,50,2020-12-14,145934460,108740,74.51290120236166,2762668,74.51290120236166
Russia,2020,18617,51,2020-12-21,145934460,315367,216.1018035082324,3078035,216.1018035082324
Russia,2020,18624,52,2020-12-28,145934460,182103,124.78409828631291,3260138,124.78409828631291
Russia,2021,18631,0,2021-01-04,145934460,165131,113.1542200519329,3425269,113.1542200519329
Russia,2021,18631,1,2021-01-04,145934460,165797,113.61058930152618,3591066,113.61058930152618
Russia,2021,18638,2,2021-01-11,145934460,147624,101.15773889182856,3738690,101.15773889182856
Russia,2021,18645,3,2021-01-18,145934460,129397,88.66788557000177,3868087,88.66788557000177
Russia,2021,18652,4,2021-01-25,145934460,115110,78.87787435537844,3983197,78.87787435537844
Russia,2021,18659,5,2021-02-01,145934460,102893,70.50630810570718,4086090,70.50630810570718
Russia,2021,18666,6,2021-02-08,145934460,91240,62.521216716051846,4177330,62.521216716051846
Russia,2021,18673,7,2021-02-15,145934460,80320,55.03840559659453,4257650,55.03840559659453
Russia,2021,18680,8,2021-02-22,145934460,75379,51.65263913677414,4333029,51.65263913677414
Russia,2021,18687,9,2021-03-01,145934460,57579,39.4553829164133,4390608,39.4553829164133
Russia,2021,18694,10,2021-03-08,145934460,75545,51.76638882961571,4466153,51.76638882961571
Russia,2021,18701,11,2021-03-15,145934460,62390,42.752068291478245,4528543,42.752068291478245
Russia,2021,18708,12,2021-03-22,145934460,52351,35.87295283101743,4580894,35.87295283101743
Russia,2021,18715,13,2021-03-29,145934460,60496,41.45422541050277,4641390,41.45422541050277
Russia,2021,18722,14,2021-04-05,145934460,60711,41.60155181990601,4702101,41.60155181990601
Russia,2021,18729,15,2021-04-12,145934460,69271,47.467198631495265,4771372,47.467198631495265
Russia,2021,18736,16,2021-04-19,145934460,51883,35.55226092589783,4823255,35.55226092589783
Russia,2021,18743,17,2021-04-26,145934460,57007,39.063426143489345,4880262,39.063426143489345
Russia,2021,18750,18,2021-05-03,145934460,69311,47.4946081960354,4949573,47.4946081960354
Russia,2021,18757,19,2021-05-10,145934460,51932,35.585837642459495,5001505,35.585837642459495
Russia,2021,18764,20,2021-05-17,145934460,70412,48.24905646000266,5071917,48.24905646000266
Russia,2021,18771,21,2021-05-24,145934460,54520,37.35923646820635,5126437,37.35923646820635
Russia,2021,18778,22,2021-05-31,145934460,95971,65.76308296203652,5222408,65.76308296203652
Russia,2021,18785,23,2021-06-07,145934460,94418,64.69890661876572,5316826,64.69890661876572
Russia,2021,18792,24,2021-06-14,145934460,156115,106.97610420458608,5472941,106.97610420458608
Russia,2021,18799,25,2021-06-21,145934460,138000,94.56299766347168,5610941,94.56299766347168
Russia,2021,18806,26,2021-06-28,145934460,197532,135.35665256855714,5808473,135.35665256855714
Russia,2021,18813,27,2021-07-05,145934460,174293,119.43238080985121,5982766,119.43238080985121
Russia,2021,18820,28,2021-07-12,145934460,167014,114.44452530265984,6149780,114.44452530265984
Russia,2021,18827,29,2021-07-19,145934460,162405,111.28625822852258,6312185,111.28625822852258
Russia,2021,18834,30,2021-07-26,145934460,135565,92.89444042209085,6447750,92.89444042209085
Russia,2021,18841,31,2021-08-02,145934460,153086,104.90051492978424,6600836,104.90051492978424
Russia,2021,18848,32,2021-08-09,145934460,146251,100.21690558898837,6747087,100.21690558898837
Russia,2021,18855,33,2021-08-16,145934460,135740,93.01435726695395,6882827,93.01435726695395
Russia,2021,18862,34,2021-08-23,145934460,129772,88.92485023756555,7012599,88.92485023756555
Russia,2021,18869,35,2021-08-30,145934460,127471,87.34811503739418,7140070,87.34811503739418
Russia,2021,18876,36,2021-09-06,145934460,134858,92.40997636884393,7274928,92.40997636884393
Russia,2021,18883,37,2021-09-13,145934460,145985,100.03463198479646,7420913,100.03463198479646
Russia,2021,18890,38,2021-09-20,145934460,191404,131.1575072810082,7612317,131.1575072810082
Russia,2021,18897,39,2021-09-27,145934460,163048,111.72686697850529,7775365,111.72686697850529
Russia,2021,18904,40,2021-10-04,145934460,217322,148.9175346247898,7992687,148.9175346247898
Russia,2021,18911,41,2021-10-11,145934460,248956,170.5943887413569,8241643,170.5943887413569
Russia,2021,18918,42,2021-10-18,145934460,272147,186.48576902261468,8513790,186.48576902261468
Russia,2021,18925,43,2021-10-25,145934460,320705,219.75960989611363,8834495,219.75960989611363
San Marino,2020,18267,0,2020-01-06,34453,0,0,0,0
San Marino,2020,18267,1,2020-01-06,34453,0,0,0,0
San Marino,2020,18274,2,2020-01-13,34453,0,0,0,0
San Marino,2020,18281,3,2020-01-20,34453,0,0,0,0
San Marino,2020,18288,4,2020-01-27,34453,0,0,0,0
San Marino,2020,18295,5,2020-02-03,34453,0,0,0,0
San Marino,2020,18302,6,2020-02-10,34453,0,0,0,0
San Marino,2020,18309,7,2020-02-17,34453,0,0,0,0
San Marino,2020,18316,8,2020-02-24,34453,8,23.220038893565146,8,23.220038893565146
San Marino,2020,18323,9,2020-03-02,34453,29,84.17264098917366,37,84.17264098917366
San Marino,2020,18330,10,2020-03-09,34453,61,177.05279656343424,98,177.05279656343424
San Marino,2020,18337,11,2020-03-16,34453,53,153.8327576698691,151,153.8327576698691
San Marino,2020,18344,12,2020-03-23,34453,78,226.39537921226017,229,226.39537921226017
San Marino,2020,18351,13,2020-03-30,34453,37,107.3926798827388,266,107.3926798827388
San Marino,2020,18358,14,2020-04-06,34453,90,261.2254375526079,356,261.2254375526079
San Marino,2020,18365,15,2020-04-13,34453,105,304.76301047804253,461,304.76301047804253
San Marino,2020,18372,16,2020-04-20,34453,77,223.49287435056453,538,223.49287435056453
San Marino,2020,18379,17,2020-04-27,34453,44,127.7102139146083,582,127.7102139146083
San Marino,2020,18386,18,2020-05-04,34453,46,133.51522363799958,628,133.51522363799958
San Marino,2020,18393,19,2020-05-11,34453,26,75.46512640408673,654,75.46512640408673
San Marino,2020,18400,20,2020-05-18,34453,11,31.927553478652076,665,31.927553478652076
San Marino,2020,18407,21,2020-05-25,34453,6,17.41502917017386,671,17.41502917017386
San Marino,2020,18414,22,2020-06-01,34453,16,46.44007778713029,687,46.44007778713029
San Marino,2020,18421,23,2020-06-08,34453,7,20.317534031869503,694,20.317534031869503
San Marino,2020,18428,24,2020-06-15,34453,2,5.8050097233912865,696,5.8050097233912865
San Marino,2020,18435,25,2020-06-22,34453,2,5.8050097233912865,698,5.8050097233912865
San Marino,2020,18442,26,2020-06-29,34453,0,0,698,0
San Marino,2020,18449,27,2020-07-06,34453,1,2.9025048616956433,699,2.9025048616956433
San Marino,2020,18456,28,2020-07-13,34453,0,0,699,0
San Marino,2020,18463,29,2020-07-20,34453,0,0,699,0
San Marino,2020,18470,30,2020-07-27,34453,0,0,699,0
San Marino,2020,18477,31,2020-08-03,34453,11,31.927553478652076,710,31.927553478652076
San Marino,2020,18484,32,2020-08-10,34453,0,0,710,0
San Marino,2020,18491,33,2020-08-17,34453,0,0,710,0
San Marino,2020,18498,34,2020-08-24,34453,0,0,710,0
San Marino,2020,18505,35,2020-08-31,34453,6,17.41502917017386,716,17.41502917017386
San Marino,2020,18512,36,2020-09-07,34453,6,17.41502917017386,722,17.41502917017386
San Marino,2020,18519,37,2020-09-14,34453,1,2.9025048616956433,723,2.9025048616956433
San Marino,2020,18526,38,2020-09-21,34453,4,11.610019446782573,727,11.610019446782573
San Marino,2020,18533,39,2020-09-28,34453,5,14.512524308478216,732,14.512524308478216
San Marino,2020,18540,40,2020-10-05,34453,20,58.050097233912865,752,58.050097233912865
San Marino,2020,18547,41,2020-10-12,34453,7,20.317534031869503,759,20.317534031869503
San Marino,2020,18554,42,2020-10-19,34453,60,174.1502917017386,819,174.1502917017386
San Marino,2020,18561,43,2020-10-26,34453,109,316.3730299248251,928,316.3730299248251
San Marino,2020,18568,44,2020-11-02,34453,115,333.78805909499897,1043,333.78805909499897
San Marino,2020,18575,45,2020-11-09,34453,210,609.5260209560851,1253,609.5260209560851
San Marino,2020,18582,46,2020-11-16,34453,142,412.15569036078136,1395,412.15569036078136
San Marino,2020,18589,47,2020-11-23,34453,191,554.3784285838678,1586,554.3784285838678
San Marino,2020,18596,48,2020-11-30,34453,203,589.2084869242155,1789,589.2084869242155
San Marino,2020,18603,49,2020-12-07,34453,158,458.59576814791166,1947,458.59576814791166
San Marino,2020,18610,50,2020-12-14,34453,160,464.4007778713029,2107,464.4007778713029
San Marino,2020,18617,51,2020-12-21,34453,168,487.6208167648681,2275,487.6208167648681
San Marino,2020,18624,52,2020-12-28,34453,218,632.7460598496502,2493,632.7460598496502
San Marino,2021,18631,0,2021-01-04,34453,174,505.03584593504195,2667,505.03584593504195
San Marino,2021,18631,1,2021-01-04,34453,120,348.3005834034772,2787,348.3005834034772
San Marino,2021,18638,2,2021-01-11,34453,87,252.51792296752097,2874,252.51792296752097
San Marino,2021,18645,3,2021-01-18,34453,151,438.27823411604214,3025,438.27823411604214
San Marino,2021,18652,4,2021-01-25,34453,112,325.08054450991204,3137,325.08054450991204
San Marino,2021,18659,5,2021-02-01,34453,180,522.4508751052158,3317,522.4508751052158
San Marino,2021,18666,6,2021-02-08,34453,155,449.88825356282473,3472,449.88825356282473
San Marino,2021,18673,7,2021-02-15,34453,244,708.211186253737,3716,708.211186253737
San Marino,2021,18680,8,2021-02-22,34453,219,635.6485647113459,3935,635.6485647113459
San Marino,2021,18687,9,2021-03-01,34453,0,0,3935,0
San Marino,2021,18694,10,2021-03-08,34453,421,1221.9545467738658,4356,1221.9545467738658
San Marino,2021,18701,11,2021-03-15,34453,0,0,4356,0
San Marino,2021,18708,12,2021-03-22,34453,419,1216.1495370504745,4775,1216.1495370504745
San Marino,2021,18715,13,2021-03-29,34453,187,542.7684091370853,4962,542.7684091370853
San Marino,2021,18722,14,2021-04-05,34453,64,185.76031114852117,5026,185.76031114852117
San Marino,2021,18729,15,2021-04-12,34453,29,84.17264098917366,5055,84.17264098917366
San Marino,2021,18736,16,2021-04-19,34453,12,34.83005834034772,5067,34.83005834034772
San Marino,2021,18743,17,2021-04-26,34453,0,0,5067,0
San Marino,2021,18750,18,2021-05-03,34453,20,58.050097233912865,5087,58.050097233912865
San Marino,2021,18757,19,2021-05-10,34453,2,5.8050097233912865,5089,5.8050097233912865
San Marino,2021,18764,20,2021-05-17,34453,1,2.9025048616956433,5090,2.9025048616956433
San Marino,2021,18771,21,2021-05-24,34453,0,0,5090,0
San Marino,2021,18778,22,2021-05-31,34453,0,0,5090,0
San Marino,2021,18785,23,2021-06-07,34453,1,2.9025048616956433,5091,2.9025048616956433
San Marino,2021,18792,24,2021-06-14,34453,1,2.9025048616956433,5092,2.9025048616956433
San Marino,2021,18799,25,2021-06-21,34453,0,0,5092,0
San Marino,2021,18806,26,2021-06-28,34453,0,0,5092,0
San Marino,2021,18813,27,2021-07-05,34453,4,11.610019446782573,5096,11.610019446782573
San Marino,2021,18820,28,2021-07-12,34453,20,58.050097233912865,5116,58.050097233912865
San Marino,2021,18827,29,2021-07-19,34453,31,89.97765071256494,5147,89.97765071256494
San Marino,2021,18834,30,2021-07-26,34453,47,136.41772849969524,5194,136.41772849969524
San Marino,2021,18841,31,2021-08-02,34453,37,107.3926798827388,5231,107.3926798827388
San Marino,2021,18848,32,2021-08-09,34453,30,87.0751458508693,5261,87.0751458508693
San Marino,2021,18855,33,2021-08-16,34453,60,174.1502917017386,5321,174.1502917017386
San Marino,2021,18862,34,2021-08-23,34453,0,0,5321,0
San Marino,2021,18869,35,2021-08-30,34453,67,194.4678257336081,5388,194.4678257336081
San Marino,2021,18876,36,2021-09-06,34453,31,89.97765071256494,5419,89.97765071256494
San Marino,2021,18883,37,2021-09-13,34453,9,26.12254375526079,5428,26.12254375526079
San Marino,2021,18890,38,2021-09-20,34453,16,46.44007778713029,5444,46.44007778713029
San Marino,2021,18897,39,2021-09-27,34453,26,75.46512640408673,5470,75.46512640408673
San Marino,2021,18904,40,2021-10-04,34453,5,14.512524308478216,5475,14.512524308478216
San Marino,2021,18911,41,2021-10-11,34453,34,98.68516529765188,5509,98.68516529765188
San Marino,2021,18918,42,2021-10-18,34453,38,110.29518474443445,5547,110.29518474443445
San Marino,2021,18925,43,2021-10-25,34453,51,148.0277479464778,5598,148.0277479464778
Serbia,2020,18330,10,2020-03-09,6926705,55,0.7940283294871082,55,0.7940283294871082
Serbia,2020,18337,11,2020-03-16,6926705,133,1.920104869487007,188,1.920104869487007
Serbia,2020,18344,12,2020-03-23,6926705,553,7.983593931024925,741,7.983593931024925
Serbia,2020,18351,13,2020-03-30,6926705,1167,16.84783746384464,1908,16.84783746384464
Serbia,2020,18358,14,2020-04-06,6926705,1722,24.86030515230546,3630,24.86030515230546
Serbia,2020,18365,15,2020-04-13,6926705,2688,38.806329993842674,6318,38.806329993842674
Serbia,2020,18372,16,2020-04-20,6926705,1724,24.889178909741357,8042,24.889178909741357
Serbia,2020,18379,17,2020-04-27,6926705,1422,20.529241536921234,9464,20.529241536921234
Serbia,2020,18386,18,2020-05-04,6926705,650,9.383971166665825,10114,9.383971166665825
Serbia,2020,18393,19,2020-05-11,6926705,496,7.160691844101922,10610,7.160691844101922
Serbia,2020,18400,20,2020-05-18,6926705,549,7.925846416153135,11159,7.925846416153135
Serbia,2020,18407,21,2020-05-25,6926705,253,3.6525303156406976,11412,3.6525303156406976
Serbia,2020,18414,22,2020-06-01,6926705,411,5.93355715307639,11823,5.93355715307639
Serbia,2020,18421,23,2020-06-08,6926705,487,7.030759935640394,12310,7.030759935640394
Serbia,2020,18428,24,2020-06-15,6926705,584,8.431137171281295,12894,8.431137171281295
Serbia,2020,18435,25,2020-06-22,6926705,1152,16.63128428307543,14046,16.63128428307543
Serbia,2020,18442,26,2020-06-29,6926705,2085,30.100892126920375,16131,30.100892126920375
Serbia,2020,18449,27,2020-07-06,6926705,2229,32.1798026623048,18360,32.1798026623048
Serbia,2020,18456,28,2020-07-13,6926705,2534,36.58305067127877,20894,36.58305067127877
Serbia,2020,18463,29,2020-07-20,6926705,2836,40.94298804409889,23730,40.94298804409889
Serbia,2020,18470,30,2020-07-27,6926705,2463,35.5580322823045,26193,35.5580322823045
Serbia,2020,18477,31,2020-08-03,6926705,1906,27.516690836407786,28099,27.516690836407786
Serbia,2020,18484,32,2020-08-10,6926705,1583,22.85357901051077,29682,22.85357901051077
Serbia,2020,18491,33,2020-08-17,6926705,975,14.075956749998737,30657,14.075956749998737
Serbia,2020,18498,34,2020-08-24,6926705,708,10.221310132306774,31365,10.221310132306774
Serbia,2020,18505,35,2020-08-31,6926705,540,7.795914507691608,31905,7.795914507691608
Serbia,2020,18512,36,2020-09-07,6926705,503,7.261749995127554,32408,7.261749995127554
Serbia,2020,18519,37,2020-09-14,6926705,500,7.218439358973711,32908,7.218439358973711
Serbia,2020,18526,38,2020-09-21,6926705,476,6.871954269742973,33384,6.871954269742973
Serbia,2020,18533,39,2020-09-28,6926705,517,7.463866297178817,33901,7.463866297178817
Serbia,2020,18540,40,2020-10-05,6926705,886,12.791074544101416,34787,12.791074544101416
Serbia,2020,18547,41,2020-10-12,6926705,1373,19.82183447974181,36160,19.82183447974181
Serbia,2020,18554,42,2020-10-19,6926705,3326,48.01705861589313,39486,48.01705861589313
Serbia,2020,18561,43,2020-10-26,6926705,8917,128.73364752793717,48403,128.73364752793717
Serbia,2020,18568,44,2020-11-02,6926705,14344,207.08258833023783,62747,207.08258833023783
Serbia,2020,18575,45,2020-11-09,6926705,21821,315.0271305043307,84568,315.0271305043307
Serbia,2020,18582,46,2020-11-16,6926705,36552,527.6967908984142,121120,527.6967908984142
Serbia,2020,18589,47,2020-11-23,6926705,48094,694.3272450609634,169214,694.3272450609634
Serbia,2020,18596,48,2020-11-30,6926705,50438,728.167288775832,219652,728.167288775832
Serbia,2020,18603,49,2020-12-07,6926705,46780,675.3571864255804,266432,675.3571864255804
Serbia,2020,18610,50,2020-12-14,6926705,37315,538.7121293602081,303747,538.7121293602081
Serbia,2020,18617,51,2020-12-21,6926705,24872,359.07404747278827,328619,359.07404747278827
Serbia,2020,18624,52,2020-12-28,6926705,15251,220.17683732741614,343870,220.17683732741614
Serbia,2021,18631,0,2021-01-04,6926705,15819,228.37698443921028,359689,228.37698443921028
Serbia,2021,18631,1,2021-01-04,6926705,12844,185.4272702533167,372533,185.4272702533167
Serbia,2021,18638,2,2021-01-11,6926705,11070,159.81624740767796,383603,159.81624740767796
Serbia,2021,18645,3,2021-01-18,6926705,11660,168.33400585126694,395263,168.33400585126694
Serbia,2021,18652,4,2021-01-25,6926705,12618,182.16453566306058,407881,182.16453566306058
Serbia,2021,18659,5,2021-02-01,6926705,12998,187.6505495758806,420879,187.6505495758806
Serbia,2021,18666,6,2021-02-08,6926705,15761,227.53964547356932,436640,227.53964547356932
Serbia,2021,18673,7,2021-02-15,6926705,22619,326.54775972125276,459259,326.54775972125276
Serbia,2021,18680,8,2021-02-22,6926705,26180,377.9574848358635,485439,377.9574848358635
Serbia,2021,18687,9,2021-03-01,6926705,30838,445.2044659040626,516277,445.2044659040626
Serbia,2021,18694,10,2021-03-08,6926705,34851,503.13966019918564,551128,503.13966019918564
Serbia,2021,18701,11,2021-03-15,6926705,34378,496.3110165655965,585506,496.3110165655965
Serbia,2021,18708,12,2021-03-22,6926705,32163,464.3333302053429,617669,464.3333302053429
Serbia,2021,18715,13,2021-03-29,6926705,24539,354.2665668597118,642208,354.2665668597118
Serbia,2021,18722,14,2021-04-05,6926705,20160,291.04747495382003,662368,291.04747495382003
Serbia,2021,18729,15,2021-04-12,6926705,17299,249.74356494177246,679667,249.74356494177246
Serbia,2021,18736,16,2021-04-19,6926705,12253,176.89507493100976,691920,176.89507493100976
Serbia,2021,18743,17,2021-04-26,6926705,8488,122.54022655793771,700408,122.54022655793771
Serbia,2021,18750,18,2021-05-03,6926705,6050,87.3431162435819,706458,87.3431162435819
Serbia,2021,18757,19,2021-05-10,6926705,3481,50.254774817174976,709939,50.254774817174976
Serbia,2021,18764,20,2021-05-17,6926705,2285,32.98826787050986,712224,32.98826787050986
Serbia,2021,18771,21,2021-05-24,6926705,1454,20.99122165589555,713678,20.99122165589555
Serbia,2021,18778,22,2021-05-31,6926705,1213,17.511933884870224,714891,17.511933884870224
Serbia,2021,18785,23,2021-06-07,6926705,862,12.444589454870679,715753,12.444589454870679
Serbia,2021,18792,24,2021-06-14,6926705,548,7.911409537435188,716301,7.911409537435188
Serbia,2021,18799,25,2021-06-21,6926705,572,8.257894626665925,716873,8.257894626665925
Serbia,2021,18806,26,2021-06-28,6926705,676,9.759330013332457,717549,9.759330013332457
Serbia,2021,18813,27,2021-07-05,6926705,1041,15.028790745383267,718590,15.028790745383267
Serbia,2021,18820,28,2021-07-12,6926705,1522,21.972929408715977,720112,21.972929408715977
Serbia,2021,18827,29,2021-07-19,6926705,2109,30.447377216151114,722221,30.447377216151114
Serbia,2021,18834,30,2021-07-26,6926705,3481,50.254774817174976,725702,50.254774817174976
Serbia,2021,18841,31,2021-08-02,6926705,6342,91.55868482922256,732044,91.55868482922256
Serbia,2021,18848,32,2021-08-09,6926705,10269,148.25230755460208,742313,148.25230755460208
Serbia,2021,18855,33,2021-08-16,6926705,15304,220.94199189946735,757617,220.94199189946735
Serbia,2021,18862,34,2021-08-23,6926705,22106,319.1416409389457,779723,319.1416409389457
Serbia,2021,18869,35,2021-08-30,6926705,43438,627.1091377502001,823161,627.1091377502001
Serbia,2021,18876,36,2021-09-06,6926705,42525,613.9282674807141,865686,613.9282674807141
Serbia,2021,18883,37,2021-09-13,6926705,45380,655.1455562204541,911066,655.1455562204541
Serbia,2021,18890,38,2021-09-20,6926705,49940,720.9777231742943,961006,720.9777231742943
Serbia,2021,18897,39,2021-09-27,6926705,44162,637.5614379419941,1005168,637.5614379419941
Serbia,2021,18904,40,2021-10-04,6926705,43667,630.4151829766101,1048835,630.4151829766101
Serbia,2021,18911,41,2021-10-11,6926705,49374,712.806449819936,1098209,712.806449819936
Serbia,2021,18918,42,2021-10-18,6926705,44540,643.0185780973782,1142749,643.0185780973782
Serbia,2021,18925,43,2021-10-25,6926705,40276,581.4597272440503,1183025,581.4597272440503
Slovakia,2020,18267,0,2020-01-06,5457873,0,0,0,0
Slovakia,2020,18267,1,2020-01-06,5457873,0,0,0,0
Slovakia,2020,18274,2,2020-01-13,5457873,0,0,0,0
Slovakia,2020,18281,3,2020-01-20,5457873,0,0,0,0
Slovakia,2020,18288,4,2020-01-27,5457873,0,0,0,0
Slovakia,2020,18295,5,2020-02-03,5457873,0,0,0,0
Slovakia,2020,18302,6,2020-02-10,5457873,0,0,0,0
Slovakia,2020,18309,7,2020-02-17,5457873,0,0,0,0
Slovakia,2020,18316,8,2020-02-24,5457873,0,0,0,0
Slovakia,2020,18323,9,2020-03-02,5457873,5,0.09161077951062621,5,0.09161077951062621
Slovakia,2020,18330,10,2020-03-09,5457873,56,1.0260407305190136,61,1.0260407305190136
Slovakia,2020,18337,11,2020-03-16,5457873,125,2.2902694877656553,186,2.2902694877656553
Slovakia,2020,18344,12,2020-03-23,5457873,162,2.968189256144289,348,2.968189256144289
Slovakia,2020,18351,13,2020-03-30,5457873,182,3.334632374186794,530,3.334632374186794
Slovakia,2020,18358,14,2020-04-06,5457873,229,4.19577370158668,759,4.19577370158668
Slovakia,2020,18365,15,2020-04-13,5457873,397,7.273895893143721,1156,7.273895893143721
Slovakia,2020,18372,16,2020-04-20,5457873,207,3.792686271739925,1363,3.792686271739925
Slovakia,2020,18379,17,2020-04-27,5457873,29,0.531342521161632,1392,0.531342521161632
Slovakia,2020,18386,18,2020-05-04,5457873,43,0.7878527037913854,1435,0.7878527037913854
Slovakia,2020,18393,19,2020-05-11,5457873,39,0.7145640801828844,1474,0.7145640801828844
Slovakia,2020,18400,20,2020-05-18,5457873,13,0.23818802672762815,1487,0.23818802672762815
Slovakia,2020,18407,21,2020-05-25,5457873,12,0.2198658708255029,1499,0.2198658708255029
Slovakia,2020,18414,22,2020-06-01,5457873,9,0.16489940311912718,1508,0.16489940311912718
Slovakia,2020,18421,23,2020-06-08,5457873,25,0.45805389755313103,1533,0.45805389755313103
Slovakia,2020,18428,24,2020-06-15,5457873,38,0.6962419242807592,1571,0.6962419242807592
Slovakia,2020,18435,25,2020-06-22,5457873,77,1.4108060044636437,1648,1.4108060044636437
Slovakia,2020,18442,26,2020-06-29,5457873,116,2.125370084646528,1764,2.125370084646528
Slovakia,2020,18449,27,2020-07-06,5457873,128,2.345235955472031,1892,2.345235955472031
Slovakia,2020,18456,28,2020-07-13,5457873,84,1.5390610957785202,1976,1.5390610957785202
Slovakia,2020,18463,29,2020-07-20,5457873,194,3.554498245012297,2170,3.554498245012297
Slovakia,2020,18470,30,2020-07-27,5457873,168,3.0781221915570405,2338,3.0781221915570405
Slovakia,2020,18477,31,2020-08-03,5457873,244,4.470606040118559,2582,4.470606040118559
Slovakia,2020,18484,32,2020-08-10,5457873,309,5.6615461737567,2891,5.6615461737567
Slovakia,2020,18491,33,2020-08-17,5457873,511,9.362621665985998,3402,9.362621665985998
Slovakia,2020,18498,34,2020-08-24,5457873,492,9.014500703845618,3894,9.014500703845618
Slovakia,2020,18505,35,2020-08-31,5457873,733,13.430140276257802,4627,13.430140276257802
Slovakia,2020,18512,36,2020-09-07,5457873,949,17.387725951116856,5576,17.387725951116856
Slovakia,2020,18519,37,2020-09-14,5457873,1197,21.931620614843915,6773,21.931620614843915
Slovakia,2020,18526,38,2020-09-21,5457873,2580,47.271162227483124,9353,47.271162227483124
Slovakia,2020,18533,39,2020-09-28,5457873,4192,76.80647754170901,13545,76.80647754170901
Slovakia,2020,18540,40,2020-10-05,5457873,6972,127.74207094961719,20517,127.74207094961719
Slovakia,2020,18547,41,2020-10-12,5457873,10346,189.56102496338775,30863,189.56102496338775
Slovakia,2020,18554,42,2020-10-19,5457873,14515,265.9460929193479,45378,265.9460929193479
Slovakia,2020,18561,43,2020-10-26,5457873,17641,323.2211522693914,63019,323.2211522693914
Slovakia,2020,18568,44,2020-11-02,5457873,13782,252.5159526430901,76801,252.5159526430901
Slovakia,2020,18575,45,2020-11-09,5457873,11283,206.7288850436791,88084,206.7288850436791
Slovakia,2020,18582,46,2020-11-16,5457873,11041,202.2949233153648,99125,202.2949233153648
Slovakia,2020,18589,47,2020-11-23,5457873,13597,249.1263538011969,112722,249.1263538011969
Slovakia,2020,18596,48,2020-11-30,5457873,17558,321.700413329515,130280,321.700413329515
Slovakia,2020,18603,49,2020-12-07,5457873,28742,526.6154049388837,159022,526.6154049388837
Slovakia,2020,18610,50,2020-12-14,5457873,39534,724.3481114346193,198556,724.3481114346193
Slovakia,2020,18617,51,2020-12-21,5457873,30203,553.3840747118887,228759,553.3840747118887
Slovakia,2020,18624,52,2020-12-28,5457873,42813,784.426460637688,271572,784.426460637688
Slovakia,2021,18631,0,2021-01-04,5457873,43334,793.9723038626952,314906,793.9723038626952
Slovakia,2021,18631,1,2021-01-04,5457873,29854,546.989642302047,344760,546.989642302047
Slovakia,2021,18638,2,2021-01-11,5457873,38064,697.4145422584952,382824,697.4145422584952
Slovakia,2021,18645,3,2021-01-18,5457873,31669,580.2443552644042,414493,580.2443552644042
Slovakia,2021,18652,4,2021-01-25,5457873,36328,665.6072796124058,450821,665.6072796124058
Slovakia,2021,18659,5,2021-02-01,5457873,34040,623.6861869083432,484861,623.6861869083432
Slovakia,2021,18666,6,2021-02-08,5457873,36363,666.2485550689802,521224,666.2485550689802
Slovakia,2021,18673,7,2021-02-15,5457873,37109,679.9168833719656,558333,679.9168833719656
Slovakia,2021,18680,8,2021-02-22,5457873,33377,611.5385975452342,591710,611.5385975452342
Slovakia,2021,18687,9,2021-03-01,5457873,28424,520.7889593620079,620134,520.7889593620079
Slovakia,2021,18694,10,2021-03-08,5457873,23494,430.4607307645304,643628,430.4607307645304
Slovakia,2021,18701,11,2021-03-15,5457873,19078,349.55009030074535,662706,349.55009030074535
Slovakia,2021,18708,12,2021-03-22,5457873,14830,271.71757202851734,677536,271.71757202851734
Slovakia,2021,18715,13,2021-03-29,5457873,11766,215.5784863444056,689302,215.5784863444056
Slovakia,2021,18722,14,2021-04-05,5457873,9772,179.04410747556787,699074,179.04410747556787
Slovakia,2021,18729,15,2021-04-12,5457873,8316,152.3670484820735,707390,152.3670484820735
Slovakia,2021,18736,16,2021-04-19,5457873,6856,125.61670086497065,714246,125.61670086497065
Slovakia,2021,18743,17,2021-04-26,5457873,4962,90.91453758634545,719208,90.91453758634545
Slovakia,2021,18750,18,2021-05-03,5457873,3739,68.50654091804628,722947,68.50654091804628
Slovakia,2021,18757,19,2021-05-10,5457873,2447,44.834315492500465,725394,44.834315492500465
Slovakia,2021,18764,20,2021-05-17,5457873,1878,34.4090087841912,727272,34.4090087841912
Slovakia,2021,18771,21,2021-05-24,5457873,1434,26.273971563647596,728706,26.273971563647596
Slovakia,2021,18778,22,2021-05-31,5457873,1002,18.35880021392949,729708,18.35880021392949
Slovakia,2021,18785,23,2021-06-07,5457873,531,9.729064784028504,730239,9.729064784028504
Slovakia,2021,18792,24,2021-06-14,5457873,391,7.16396295773097,730630,7.16396295773097
Slovakia,2021,18799,25,2021-06-21,5457873,229,4.19577370158668,730859,4.19577370158668
Slovakia,2021,18806,26,2021-06-28,5457873,234,4.287384481097306,731093,4.287384481097306
Slovakia,2021,18813,27,2021-07-05,5457873,215,3.939263518956927,731308,3.939263518956927
Slovakia,2021,18820,28,2021-07-12,5457873,318,5.826445576875827,731626,5.826445576875827
Slovakia,2021,18827,29,2021-07-19,5457873,418,7.658661167088351,732044,7.658661167088351
Slovakia,2021,18834,30,2021-07-26,5457873,422,7.731949790696852,732466,7.731949790696852
Slovakia,2021,18841,31,2021-08-02,5457873,568,10.406984552407136,733034,10.406984552407136
Slovakia,2021,18848,32,2021-08-09,5457873,677,12.404099545738788,733711,12.404099545738788
Slovakia,2021,18855,33,2021-08-16,5457873,821,15.042489995644823,734532,15.042489995644823
Slovakia,2021,18862,34,2021-08-23,5457873,1713,31.38585306034054,736245,31.38585306034054
Slovakia,2021,18869,35,2021-08-30,5457873,3070,56.24901861952449,739315,56.24901861952449
Slovakia,2021,18876,36,2021-09-06,5457873,4925,90.23661781796682,744240,90.23661781796682
Slovakia,2021,18883,37,2021-09-13,5457873,6560,120.19334271794159,750800,120.19334271794159
Slovakia,2021,18890,38,2021-09-20,5457873,8757,160.44711923491073,759557,160.44711923491073
Slovakia,2021,18897,39,2021-09-27,5457873,10947,200.572640660565,770504,200.572640660565
Slovakia,2021,18904,40,2021-10-04,5457873,13448,246.39635257178026,783952,246.39635257178026
Slovakia,2021,18911,41,2021-10-11,5457873,22474,411.7721317443627,806426,411.7721317443627
Slovakia,2021,18918,42,2021-10-18,5457873,32852,601.9194656966184,839278,601.9194656966184
Slovakia,2021,18925,43,2021-10-25,5457873,43144,790.4910942412914,882422,790.4910942412914
Slovenia,2020,18267,0,2020-01-06,2095861,0,0,0,0
Slovenia,2020,18267,1,2020-01-06,2095861,0,0,0,0
Slovenia,2020,18274,2,2020-01-13,2095861,0,0,0,0
Slovenia,2020,18281,3,2020-01-20,2095861,0,0,0,0
Slovenia,2020,18288,4,2020-01-27,2095861,0,0,0,0
Slovenia,2020,18295,5,2020-02-03,2095861,0,0,0,0
Slovenia,2020,18302,6,2020-02-10,2095861,0,0,0,0
Slovenia,2020,18309,7,2020-02-17,2095861,0,0,0,0
Slovenia,2020,18316,8,2020-02-24,2095861,0,0,0,0
Slovenia,2020,18323,9,2020-03-02,2095861,20,0.9542617568626927,20,0.9542617568626927
Slovenia,2020,18330,10,2020-03-09,2095861,230,10.974010203920965,250,10.974010203920965
Slovenia,2020,18337,11,2020-03-16,2095861,192,9.16091286588185,442,9.16091286588185
Slovenia,2020,18344,12,2020-03-23,2095861,315,15.02962267058741,757,15.02962267058741
Slovenia,2020,18351,13,2020-03-30,2095861,264,12.596255190587543,1021,12.596255190587543
Slovenia,2020,18358,14,2020-04-06,2095861,192,9.16091286588185,1213,9.16091286588185
Slovenia,2020,18365,15,2020-04-13,2095861,123,5.86870980470556,1336,5.86870980470556
Slovenia,2020,18372,16,2020-04-20,2095861,67,3.1967768854900207,1403,3.1967768854900207
Slovenia,2020,18379,17,2020-04-27,2095861,36,1.717671162352847,1439,1.717671162352847
Slovenia,2020,18386,18,2020-05-04,2095861,21,1.0019748447058274,1460,1.0019748447058274
Slovenia,2020,18393,19,2020-05-11,2095861,6,0.2862785270588078,1466,0.2862785270588078
Slovenia,2020,18400,20,2020-05-18,2095861,3,0.1431392635294039,1469,0.1431392635294039
Slovenia,2020,18407,21,2020-05-25,2095861,4,0.19085235137253853,1473,0.19085235137253853
Slovenia,2020,18414,22,2020-06-01,2095861,12,0.5725570541176156,1485,0.5725570541176156
Slovenia,2020,18421,23,2020-06-08,2095861,11,0.524843966274481,1496,0.524843966274481
Slovenia,2020,18428,24,2020-06-15,2095861,25,1.1928271960783658,1521,1.1928271960783658
Slovenia,2020,18435,25,2020-06-22,2095861,63,3.005924534117482,1584,3.005924534117482
Slovenia,2020,18442,26,2020-06-29,2095861,132,6.298127595293772,1716,6.298127595293772
Slovenia,2020,18449,27,2020-07-06,2095861,134,6.393553770980041,1850,6.393553770980041
Slovenia,2020,18456,28,2020-07-13,2095861,104,4.962161135686002,1954,4.962161135686002
Slovenia,2020,18463,29,2020-07-20,2095861,134,6.393553770980041,2088,6.393553770980041
Slovenia,2020,18470,30,2020-07-27,2095861,94,4.485030257254656,2182,4.485030257254656
Slovenia,2020,18477,31,2020-08-03,2095861,74,3.530768500391963,2256,3.530768500391963
Slovenia,2020,18484,32,2020-08-10,2095861,174,8.302077284705426,2430,8.302077284705426
Slovenia,2020,18491,33,2020-08-17,2095861,236,11.260288730979774,2666,11.260288730979774
Slovenia,2020,18498,34,2020-08-24,2095861,218,10.40145314980335,2884,10.40145314980335
Slovenia,2020,18505,35,2020-08-31,2095861,307,14.647917967842334,3191,14.647917967842334
Slovenia,2020,18512,36,2020-09-07,2095861,559,26.67161610431226,3750,26.67161610431226
Slovenia,2020,18519,37,2020-09-14,2095861,721,34.40113633490007,4471,34.40113633490007
Slovenia,2020,18526,38,2020-09-21,2095861,919,43.84832772784073,5390,43.84832772784073
Slovenia,2020,18533,39,2020-09-28,2095861,1186,56.58772218195768,6576,56.58772218195768
Slovenia,2020,18540,40,2020-10-05,2095861,2258,107.736152349798,8834,107.736152349798
Slovenia,2020,18547,41,2020-10-12,2095861,4852,231.50390221488925,13686,231.50390221488925
Slovenia,2020,18554,42,2020-10-19,2095861,10427,497.50436694036483,24113,497.50436694036483
Slovenia,2020,18561,43,2020-10-26,2095861,12106,577.6146414289879,36219,577.6146414289879
Slovenia,2020,18568,44,2020-11-02,2095861,9437,450.26840997566154,45656,450.26840997566154
Slovenia,2020,18575,45,2020-11-09,2095861,9927,473.6478230187975,55583,473.6478230187975
Slovenia,2020,18582,46,2020-11-16,2095861,10215,487.3891923176203,65798,487.3891923176203
Slovenia,2020,18589,47,2020-11-23,2095861,10073,480.61393384389515,75871,480.61393384389515
Slovenia,2020,18596,48,2020-11-30,2095861,10459,499.03118575134516,86330,499.03118575134516
Slovenia,2020,18603,49,2020-12-07,2095861,10455,498.8403333999726,96785,498.8403333999726
Slovenia,2020,18610,50,2020-12-14,2095861,9517,454.0854570031123,106302,454.0854570031123
Slovenia,2020,18617,51,2020-12-21,2095861,9109,434.6185171631134,115411,434.6185171631134
Slovenia,2020,18624,52,2020-12-28,2095861,10548,503.27765056938415,125959,503.27765056938415
Slovenia,2021,18631,0,2021-01-04,2095861,13865,661.5419629450618,139824,661.5419629450618
Slovenia,2021,18631,1,2021-01-04,2095861,9746,465.01175411919013,149570,465.01175411919013
Slovenia,2021,18638,2,2021-01-11,2095861,8700,415.1038642352713,158270,415.1038642352713
Slovenia,2021,18645,3,2021-01-18,2095861,8643,412.38421822821266,166913,412.38421822821266
Slovenia,2021,18652,4,2021-01-25,2095861,7099,338.7152105984128,174012,338.7152105984128
Slovenia,2021,18659,5,2021-02-01,2095861,5714,272.63258393567133,179726,272.63258393567133
Slovenia,2021,18666,6,2021-02-08,2095861,5256,250.77998970351564,184982,250.77998970351564
Slovenia,2021,18673,7,2021-02-15,2095861,5425,258.8435015490054,190407,258.8435015490054
Slovenia,2021,18680,8,2021-02-22,2095861,5368,256.12385554194674,195775,256.12385554194674
Slovenia,2021,18687,9,2021-03-01,2095861,4874,232.5535901474382,200649,232.5535901474382
Slovenia,2021,18694,10,2021-03-08,2095861,5794,276.4496309631221,206443,276.4496309631221
Slovenia,2021,18701,11,2021-03-15,2095861,6655,317.530599596061,213098,317.530599596061
Slovenia,2021,18708,12,2021-03-22,2095861,7468,356.32134001252945,220566,356.32134001252945
Slovenia,2021,18715,13,2021-03-29,2095861,6373,304.075508824297,226939,304.075508824297
Slovenia,2021,18722,14,2021-04-05,2095861,5521,263.42395798194633,232460,263.42395798194633
Slovenia,2021,18729,15,2021-04-12,2095861,4844,231.12219751214417,237304,231.12219751214417
Slovenia,2021,18736,16,2021-04-19,2095861,4677,223.15411184234068,241981,223.15411184234068
Slovenia,2021,18743,17,2021-04-26,2095861,4278,204.11658979292997,246259,204.11658979292997
Slovenia,2021,18750,18,2021-05-03,2095861,3192,152.30017639528575,249451,152.30017639528575
Slovenia,2021,18757,19,2021-05-10,2095861,2349,112.07804334352326,251800,112.07804334352326
Slovenia,2021,18764,20,2021-05-17,2095861,1955,93.27908673332821,253755,93.27908673332821
Slovenia,2021,18771,21,2021-05-24,2095861,1710,81.58938021176023,255465,81.58938021176023
Slovenia,2021,18778,22,2021-05-31,2095861,1033,49.287619741958075,256498,49.287619741958075
Slovenia,2021,18785,23,2021-06-07,2095861,529,25.240223469018222,257027,25.240223469018222
Slovenia,2021,18792,24,2021-06-14,2095861,251,11.975985048626793,257278,11.975985048626793
Slovenia,2021,18799,25,2021-06-21,2095861,177,8.44521654823483,257455,8.44521654823483
Slovenia,2021,18806,26,2021-06-28,2095861,386,18.41725190744997,257841,18.41725190744997
Slovenia,2021,18813,27,2021-07-05,2095861,377,17.98783411686176,258218,17.98783411686176
Slovenia,2021,18820,28,2021-07-12,2095861,473,22.568290549802683,258691,22.568290549802683
Slovenia,2021,18827,29,2021-07-19,2095861,631,30.106958429017954,259322,30.106958429017954
Slovenia,2021,18834,30,2021-07-26,2095861,848,40.46069849097817,260170,40.46069849097817
Slovenia,2021,18841,31,2021-08-02,2095861,1332,63.55383300705533,261502,63.55383300705533
Slovenia,2021,18848,32,2021-08-09,2095861,2167,103.39426135607276,263669,103.39426135607276
Slovenia,2021,18855,33,2021-08-16,2095861,2997,142.9961242658745,266666,142.9961242658745
Slovenia,2021,18862,34,2021-08-23,2095861,3881,185.17449391920553,270547,185.17449391920553
Slovenia,2021,18869,35,2021-08-30,2095861,5918,282.36605385567077,276465,282.36605385567077
Slovenia,2021,18876,36,2021-09-06,2095861,7314,348.9735244846867,283779,348.9735244846867
Slovenia,2021,18883,37,2021-09-13,2095861,6184,295.0577352219446,289963,295.0577352219446
Slovenia,2021,18890,38,2021-09-20,2095861,6131,292.5289415662584,296094,292.5289415662584
Slovenia,2021,18897,39,2021-09-27,2095861,5559,265.2370553199854,301653,265.2370553199854
Slovenia,2021,18904,40,2021-10-04,2095861,6854,327.0255040768448,308507,327.0255040768448
Slovenia,2021,18911,41,2021-10-11,2095861,12123,578.4257639223212,320630,578.4257639223212
Slovenia,2021,18918,42,2021-10-18,2095861,16495,787.0273839725058,337125,787.0273839725058
Slovenia,2021,18925,43,2021-10-25,2095861,20170,962.3729817960256,357295,962.3729817960256
Spain,2020,18267,0,2020-01-06,47332614,0,0,0,0
Spain,2020,18267,1,2020-01-06,47332614,0,0,0,0
Spain,2020,18274,2,2020-01-13,47332614,1,0.0021127081635508235,1,0.0021127081635508235
Spain,2020,18281,3,2020-01-20,47332614,0,0,1,0
Spain,2020,18288,4,2020-01-27,47332614,1,0.0021127081635508235,2,0.0021127081635508235
Spain,2020,18295,5,2020-02-03,47332614,1,0.0021127081635508235,3,0.0021127081635508235
Spain,2020,18302,6,2020-02-10,47332614,3,0.006338124490652471,6,0.006338124490652471
Spain,2020,18309,7,2020-02-17,47332614,4,0.008450832654203294,10,0.008450832654203294
Spain,2020,18316,8,2020-02-24,47332614,107,0.2260597734999381,117,0.2260597734999381
Spain,2020,18323,9,2020-03-02,47332614,1342,2.835254355485205,1459,2.835254355485205
Spain,2020,18330,10,2020-03-09,47332614,11281,23.83346079301684,12740,23.83346079301684
Spain,2020,18337,11,2020-03-16,47332614,35914,75.87580098576427,48654,75.87580098576427
Spain,2020,18344,12,2020-03-23,47332614,59024,124.70048664542381,107678,124.70048664542381
Spain,2020,18351,13,2020-03-30,47332614,44207,93.39648978609125,151885,93.39648978609125
Spain,2020,18358,14,2020-04-06,47332614,30378,64.17984859234691,182263,64.17984859234691
Spain,2020,18365,15,2020-04-13,47332614,21114,44.607720165212086,203377,44.607720165212086
Spain,2020,18372,16,2020-04-20,47332614,14497,30.62793024699629,217874,30.62793024699629
Spain,2020,18379,17,2020-04-27,47332614,8117,17.148852163542035,225991,17.148852163542035
Spain,2020,18386,18,2020-05-04,47332614,5560,11.746657389342579,231551,11.746657389342579
Spain,2020,18393,19,2020-05-11,47332614,5180,10.943828287193266,236731,10.943828287193266
Spain,2020,18400,20,2020-05-18,47332614,4763,10.062828982992572,241494,10.062828982992572
Spain,2020,18407,21,2020-05-25,47332614,3723,7.865612492899716,245217,7.865612492899716
Spain,2020,18414,22,2020-06-01,47332614,3292,6.955035274409311,248509,6.955035274409311
Spain,2020,18421,23,2020-06-08,47332614,2254,4.762044200643556,250763,4.762044200643556
Spain,2020,18428,24,2020-06-15,47332614,2104,4.445137976110932,252867,4.445137976110932
Spain,2020,18435,25,2020-06-22,47332614,2263,4.781058574115514,255130,4.781058574115514
Spain,2020,18442,26,2020-06-29,47332614,2763,5.837412655890925,257893,5.837412655890925
Spain,2020,18449,27,2020-07-06,47332614,4777,10.092406897282284,262670,10.092406897282284
Spain,2020,18456,28,2020-07-13,47332614,10059,21.251731417157735,272729,21.251731417157735
Spain,2020,18463,29,2020-07-20,47332614,14660,30.97230167765507,287389,30.97230167765507
Spain,2020,18470,30,2020-07-27,47332614,20301,42.89008842824527,307690,42.89008842824527
Spain,2020,18477,31,2020-08-03,47332614,28033,59.225547948820235,335723,59.225547948820235
Spain,2020,18484,32,2020-08-10,47332614,39764,84.00972741543495,375487,84.00972741543495
Spain,2020,18491,33,2020-08-17,47332614,51963,109.78265430259144,427450,109.78265430259144
Spain,2020,18498,34,2020-08-24,47332614,60980,128.83294381332922,488430,128.83294381332922
Spain,2020,18505,35,2020-08-31,47332614,65351,138.06759119620986,553781,138.06759119620986
Spain,2020,18512,36,2020-09-07,47332614,73914,156.15871120069556,627695,156.15871120069556
Spain,2020,18519,37,2020-09-14,47332614,80764,170.6307621210187,708459,170.6307621210187
Spain,2020,18526,38,2020-09-21,47332614,72520,153.21359602070572,780979,153.21359602070572
Spain,2020,18533,39,2020-09-28,47332614,65070,137.4739202022521,846049,137.4739202022521
Spain,2020,18540,40,2020-10-05,47332614,77678,164.11094472830086,923727,164.11094472830086
Spain,2020,18547,41,2020-10-12,47332614,91179,192.63461764440055,1014906,192.63461764440055
Spain,2020,18554,42,2020-10-19,47332614,135650,286.5888623856692,1150556,286.5888623856692
Spain,2020,18561,43,2020-10-26,47332614,145425,307.2405846843785,1295981,307.2405846843785
Spain,2020,18568,44,2020-11-02,47332614,133206,281.425403633951,1429187,281.425403633951
Spain,2020,18575,45,2020-11-09,47332614,112041,236.70993535239782,1541228,236.70993535239782
Spain,2020,18582,46,2020-11-16,47332614,81140,171.42514039051383,1622368,171.42514039051383
Spain,2020,18589,47,2020-11-23,47332614,58582,123.76666963713434,1680950,123.76666963713434
Spain,2020,18596,48,2020-11-30,47332614,50565,106.82908828994739,1731515,106.82908828994739
Spain,2020,18603,49,2020-12-07,47332614,50544,106.78472141851283,1782059,106.78472141851283
Spain,2020,18610,50,2020-12-14,47332614,68280,144.25571340725023,1850339,144.25571340725023
Spain,2020,18617,51,2020-12-21,47332614,66065,139.57606482498517,1916404,139.57606482498517
Spain,2020,18624,52,2020-12-28,47332614,98382,207.85245454645712,2014786,207.85245454645712
Spain,2021,18631,0,2021-01-04,47332614,159751,337.5072418354076,2174537,337.5072418354076
Spain,2021,18631,1,2021-01-04,47332614,233485,493.285665566664,2408022,493.285665566664
Spain,2021,18638,2,2021-01-11,47332614,244052,515.6106527309056,2652074,515.6106527309056
Spain,2021,18645,3,2021-01-18,47332614,201525,425.7635126595797,2853599,425.7635126595797
Spain,2021,18652,4,2021-01-25,47332614,129887,274.4133252391258,2983486,274.4133252391258
Spain,2021,18659,5,2021-02-01,47332614,75326,159.14185512762933,3058812,159.14185512762933
Spain,2021,18666,6,2021-02-08,47332614,50165,105.98400502452706,3108977,105.98400502452706
Spain,2021,18673,7,2021-02-15,47332614,38788,81.94772424780935,3147765,81.94772424780935
Spain,2021,18680,8,2021-02-22,47332614,33472,70.71656765037316,3181237,70.71656765037316
Spain,2021,18687,9,2021-03-01,47332614,32311,68.26371347249066,3213548,68.26371347249066
Spain,2021,18694,10,2021-03-08,47332614,33851,71.51728404435893,3247399,71.51728404435893
Spain,2021,18701,11,2021-03-15,47332614,42552,89.89995777541465,3289951,89.89995777541465
Spain,2021,18708,12,2021-03-22,47332614,43044,90.93941019188165,3332995,90.93941019188165
Spain,2021,18715,13,2021-03-29,47332614,59796,126.33149734768504,3392791,126.33149734768504
Spain,2021,18722,14,2021-04-05,47332614,58833,124.2969593861856,3451624,124.2969593861856
Spain,2021,18729,15,2021-04-12,47332614,58101,122.7504570104664,3509725,122.7504570104664
Spain,2021,18736,16,2021-04-19,47332614,53381,112.77847447850651,3563106,112.77847447850651
Spain,2021,18743,17,2021-04-26,47332614,42110,88.96614076712518,3605216,88.96614076712518
Spain,2021,18750,18,2021-05-03,47332614,34829,73.58351262831164,3640045,73.58351262831164
Spain,2021,18757,19,2021-05-10,47332614,32526,68.71794572765408,3672571,68.71794572765408
Spain,2021,18764,20,2021-05-17,47332614,30951,65.39043037006154,3703522,65.39043037006154
Spain,2021,18771,21,2021-05-24,47332614,28479,60.16781578976391,3732001,60.16781578976391
Spain,2021,18778,22,2021-05-31,47332614,24359,51.46345815593451,3756360,51.46345815593451
Spain,2021,18785,23,2021-06-07,47332614,23691,50.05216910268256,3780051,50.05216910268256
Spain,2021,18792,24,2021-06-14,47332614,29794,62.946027024833235,3809845,62.946027024833235
Spain,2021,18799,25,2021-06-21,47332614,78667,166.20041310205264,3888512,166.20041310205264
Spain,2021,18806,26,2021-06-28,47332614,134503,284.16558612207643,4023015,284.16558612207643
Spain,2021,18813,27,2021-07-05,47332614,175999,371.8345240767814,4199014,371.8345240767814
Spain,2021,18820,28,2021-07-12,47332614,185314,391.51440062025733,4384328,391.51440062025733
Spain,2021,18827,29,2021-07-19,47332614,156877,331.43531857336257,4541205,331.43531857336257
Spain,2021,18834,30,2021-07-26,47332614,118597,250.560850072637,4659802,250.560850072637
Spain,2021,18841,31,2021-08-02,47332614,90183,190.5303603135039,4749985,190.5303603135039
Spain,2021,18848,32,2021-08-09,47332614,68168,144.01909009293254,4818153,144.01909009293254
Spain,2021,18855,33,2021-08-16,47332614,51368,108.5255929452787,4869521,108.5255929452787
Spain,2021,18862,34,2021-08-23,47332614,33975,71.77925985663923,4903496,71.77925985663923
Spain,2021,18869,35,2021-08-30,47332614,23206,49.02750564336041,4926702,49.02750564336041
Spain,2021,18876,36,2021-09-06,47332614,17820,37.64845947447567,4944522,37.64845947447567
Spain,2021,18883,37,2021-09-13,47332614,14504,30.642719204141144,4959026,30.642719204141144
Spain,2021,18890,38,2021-09-20,47332614,12222,25.821519174918166,4971248,25.821519174918166
Spain,2021,18897,39,2021-09-27,47332614,10451,22.079913017269657,4981699,22.079913017269657
Spain,2021,18904,40,2021-10-04,47332614,10672,22.54682152141439,4992371,22.54682152141439
Spain,2021,18911,41,2021-10-11,47332614,12280,25.944056248404113,5004651,25.944056248404113
Spain,2021,18918,42,2021-10-18,47332614,13271,28.03775003848298,5017922,28.03775003848298
Spain,2021,18925,43,2021-10-25,47332614,15901,33.59417250862165,5033823,33.59417250862165
Sweden,2020,18267,0,2020-01-06,10327589,0,0,0,0
Sweden,2020,18267,1,2020-01-06,10327589,0,0,0,0
Sweden,2020,18274,2,2020-01-13,10327589,0,0,0,0
Sweden,2020,18281,3,2020-01-20,10327589,0,0,0,0
Sweden,2020,18288,4,2020-01-27,10327589,0,0,0,0
Sweden,2020,18295,5,2020-02-03,10327589,1,0.009682802055736338,1,0.009682802055736338
Sweden,2020,18302,6,2020-02-10,10327589,0,0,1,0
Sweden,2020,18309,7,2020-02-17,10327589,0,0,1,0
Sweden,2020,18316,8,2020-02-24,10327589,13,0.12587642672457242,14,0.12587642672457242
Sweden,2020,18323,9,2020-03-02,10327589,211,2.0430712337603674,225,2.0430712337603674
Sweden,2020,18330,10,2020-03-09,10327589,836,8.09482251859558,1061,8.09482251859558
Sweden,2020,18337,11,2020-03-16,10327589,914,8.850081078943013,1975,8.850081078943013
Sweden,2020,18344,12,2020-03-23,10327589,1941,18.794318790184235,3916,18.794318790184235
Sweden,2020,18351,13,2020-03-30,10327589,3211,31.091477400969385,7127,31.091477400969385
Sweden,2020,18358,14,2020-04-06,10327589,3711,35.932878428837554,10838,35.932878428837554
Sweden,2020,18365,15,2020-04-13,10327589,3739,36.20399688639817,14577,36.20399688639817
Sweden,2020,18372,16,2020-04-20,10327589,4178,40.454746988866425,18755,40.454746988866425
Sweden,2020,18379,17,2020-04-27,10327589,3801,36.80433061385382,22556,36.80433061385382
Sweden,2020,18386,18,2020-05-04,10327589,4133,40.01902089635829,26689,40.01902089635829
Sweden,2020,18393,19,2020-05-11,10327589,3852,37.298153518696374,30541,37.298153518696374
Sweden,2020,18400,20,2020-05-18,10327589,3645,35.29381349315896,34186,35.29381349315896
Sweden,2020,18407,21,2020-05-25,10327589,4258,41.22937115332533,38444,41.22937115332533
Sweden,2020,18414,22,2020-06-01,10327589,6007,58.16459194880819,44451,58.16459194880819
Sweden,2020,18421,23,2020-06-08,10327589,7118,68.92218503273126,51569,68.92218503273126
Sweden,2020,18428,24,2020-06-15,10327589,7063,68.38963091966576,58632,68.38963091966576
Sweden,2020,18435,25,2020-06-22,10327589,7451,72.14655811729146,66083,72.14655811729146
Sweden,2020,18442,26,2020-06-29,10327589,4276,41.40366159032858,70359,41.40366159032858
Sweden,2020,18449,27,2020-07-06,10327589,2178,21.089142877393748,72537,21.089142877393748
Sweden,2020,18456,28,2020-07-13,10327589,1621,15.695822132348605,74158,15.695822132348605
Sweden,2020,18463,29,2020-07-20,10327589,1316,12.742567505349022,75474,12.742567505349022
Sweden,2020,18470,30,2020-07-27,10327589,1553,15.037391592558535,77027,15.037391592558535
Sweden,2020,18477,31,2020-08-03,10327589,2013,19.49148053819725,79040,19.49148053819725
Sweden,2020,18484,32,2020-08-10,10327589,2052,19.869109818370966,81092,19.869109818370966
Sweden,2020,18491,33,2020-08-17,10327589,1687,16.334887068027204,82779,16.334887068027204
Sweden,2020,18498,34,2020-08-24,10327589,1200,11.619362466883606,83979,11.619362466883606
Sweden,2020,18505,35,2020-08-31,10327589,1331,12.887809536185067,85310,12.887809536185067
Sweden,2020,18512,36,2020-09-07,10327589,1592,15.415020872732251,86902,15.415020872732251
Sweden,2020,18519,37,2020-09-14,10327589,2080,20.140228275931584,88982,20.140228275931584
Sweden,2020,18526,38,2020-09-21,10327589,2919,28.264099200694375,91901,28.264099200694375
Sweden,2020,18533,39,2020-09-28,10327589,3642,35.264765086991744,95543,35.264765086991744
Sweden,2020,18540,40,2020-10-05,10327589,4278,41.42302719444006,99821,41.42302719444006
Sweden,2020,18547,41,2020-10-12,10327589,5620,54.41734755323822,105441,54.41734755323822
Sweden,2020,18554,42,2020-10-19,10327589,9154,88.63637001821044,114595,88.63637001821044
Sweden,2020,18561,43,2020-10-26,10327589,18467,178.81230556328296,133062,178.81230556328296
Sweden,2020,18568,44,2020-11-02,10327589,25403,245.9722206218702,158465,245.9722206218702
Sweden,2020,18575,45,2020-11-09,10327589,31315,303.21694637538343,189780,303.21694637538343
Sweden,2020,18582,46,2020-11-16,10327589,31941,309.2783804622744,221721,309.2783804622744
Sweden,2020,18589,47,2020-11-23,10327589,35552,344.24297868553833,257273,344.24297868553833
Sweden,2020,18596,48,2020-11-30,10327589,36830,356.61759971276933,294103,356.61759971276933
Sweden,2020,18603,49,2020-12-07,10327589,43630,422.4606536917765,337733,422.4606536917765
Sweden,2020,18610,50,2020-12-14,10327589,46174,447.0937021215697,383907,447.0937021215697
Sweden,2020,18617,51,2020-12-21,10327589,37134,359.5611715377132,421041,359.5611715377132
Sweden,2020,18624,52,2020-12-28,10327589,41321,400.1030637450813,462362,400.1030637450813
Sweden,2021,18631,0,2021-01-04,10327589,39454,382.0252723070215,501816,382.0252723070215
Sweden,2021,18631,1,2021-01-04,10327589,28937,280.19124308684246,530753,280.19124308684246
Sweden,2021,18638,2,2021-01-11,10327589,23229,224.92180895269942,553982,224.92180895269942
Sweden,2021,18645,3,2021-01-18,10327589,20655,199.99827646123407,574637,199.99827646123407
Sweden,2021,18652,4,2021-01-25,10327589,19603,189.81196869859946,594240,189.81196869859946
Sweden,2021,18659,5,2021-02-01,10327589,21281,206.05971054812503,615521,206.05971054812503
Sweden,2021,18666,6,2021-02-08,10327589,23609,228.60127373387922,639130,228.60127373387922
Sweden,2021,18673,7,2021-02-15,10327589,26689,258.4243040655472,665819,258.4243040655472
Sweden,2021,18680,8,2021-02-22,10327589,27748,268.6783914425719,693567,268.6783914425719
Sweden,2021,18687,9,2021-03-01,10327589,28553,276.4730470974397,722120,276.4730470974397
Sweden,2021,18694,10,2021-03-08,10327589,33032,319.84231750508275,755152,319.84231750508275
Sweden,2021,18701,11,2021-03-15,10327589,37881,366.79422467334825,793033,366.79422467334825
Sweden,2021,18708,12,2021-03-22,10327589,38382,371.64530850327213,831415,371.64530850327213
Sweden,2021,18715,13,2021-03-29,10327589,41146,398.4085733853274,872561,398.4085733853274
Sweden,2021,18722,14,2021-04-05,10327589,41034,397.32409955508496,913595,397.32409955508496
Sweden,2021,18729,15,2021-04-12,10327589,36030,348.8713580681803,949625,348.8713580681803
Sweden,2021,18736,16,2021-04-19,10327589,35306,341.8610093798272,984931,341.8610093798272
Sweden,2021,18743,17,2021-04-26,10327589,33680,326.1167732371999,1018611,326.1167732371999
Sweden,2021,18750,18,2021-05-03,10327589,25914,250.9201324723515,1044525,250.9201324723515
Sweden,2021,18757,19,2021-05-10,10327589,18168,175.9171477486178,1062693,175.9171477486178
Sweden,2021,18764,20,2021-05-17,10327589,7974,77.21066359244156,1070667,77.21066359244156
Sweden,2021,18771,21,2021-05-24,10327589,9094,88.05540189486626,1079761,88.05540189486626
Sweden,2021,18778,22,2021-05-31,10327589,4394,42.546232232905474,1084155,42.546232232905474
Sweden,2021,18785,23,2021-06-07,10327589,2848,27.576620254737094,1087003,27.576620254737094
Sweden,2021,18792,24,2021-06-14,10327589,1982,19.191313674469423,1088985,19.191313674469423
Sweden,2021,18799,25,2021-06-21,10327589,1869,18.09715704217122,1090854,18.09715704217122
Sweden,2021,18806,26,2021-06-28,10327589,1514,14.659762312384817,1092368,14.659762312384817
Sweden,2021,18813,27,2021-07-05,10327589,1881,18.213350666840054,1094249,18.213350666840054
Sweden,2021,18820,28,2021-07-12,10327589,2662,25.775619072370134,1096911,25.775619072370134
Sweden,2021,18827,29,2021-07-19,10327589,3459,33.492812310792,1100370,33.492812310792
Sweden,2021,18834,30,2021-07-26,10327589,4608,44.61835187283305,1104978,44.61835187283305
Sweden,2021,18841,31,2021-08-02,10327589,5820,56.35390796438549,1110798,56.35390796438549
Sweden,2021,18848,32,2021-08-09,10327589,6465,62.59931529033543,1117263,62.59931529033543
Sweden,2021,18855,33,2021-08-16,10327589,6689,64.76826295082037,1123952,64.76826295082037
Sweden,2021,18862,34,2021-08-23,10327589,7238,70.08412127941962,1131190,70.08412127941962
Sweden,2021,18869,35,2021-08-30,10327589,7969,77.16224958216289,1139159,77.16224958216289
Sweden,2021,18876,36,2021-09-06,10327589,6264,60.65307207713243,1145423,60.65307207713243
Sweden,2021,18883,37,2021-09-13,10327589,4306,41.69414565200068,1149729,41.69414565200068
Sweden,2021,18890,38,2021-09-20,10327589,4238,41.0357151122106,1153967,41.0357151122106
Sweden,2021,18897,39,2021-09-27,10327589,4140,40.08680051074844,1158107,40.08680051074844
Sweden,2021,18904,40,2021-10-04,10327589,4070,39.4090043668469,1162177,39.4090043668469
Sweden,2021,18911,41,2021-10-11,10327589,5194,50.292473877494544,1167371,50.292473877494544
Sweden,2021,18918,42,2021-10-18,10327589,5912,57.24472575351324,1173283,57.24472575351324
Sweden,2021,18925,43,2021-10-25,10327589,5062,49.01434400613735,1178345,49.01434400613735
Switzerland,2020,18267,0,2020-01-06,8606033,0,0,0,0
Switzerland,2020,18267,1,2020-01-06,8606033,0,0,0,0
Switzerland,2020,18274,2,2020-01-13,8606033,0,0,0,0
Switzerland,2020,18281,3,2020-01-20,8606033,0,0,0,0
Switzerland,2020,18288,4,2020-01-27,8606033,0,0,0,0
Switzerland,2020,18295,5,2020-02-03,8606033,0,0,0,0
Switzerland,2020,18302,6,2020-02-10,8606033,0,0,0,0
Switzerland,2020,18309,7,2020-02-17,8606033,0,0,0,0
Switzerland,2020,18316,8,2020-02-24,8606033,24,0.27887413399414107,24,0.27887413399414107
Switzerland,2020,18323,9,2020-03-02,8606033,308,3.5788847195914775,332,3.5788847195914775
Switzerland,2020,18330,10,2020-03-09,8606033,1868,21.705703429210647,2200,21.705703429210647
Switzerland,2020,18337,11,2020-03-16,8606033,4771,55.43785388691863,6971,55.43785388691863
Switzerland,2020,18344,12,2020-03-23,8606033,7303,84.85907502330052,14274,84.85907502330052
Switzerland,2020,18351,13,2020-03-30,8606033,6748,78.410110674686,21022,78.410110674686
Switzerland,2020,18358,14,2020-04-06,8606033,4198,48.77973393780851,25220,48.77973393780851
Switzerland,2020,18365,15,2020-04-13,8606033,2438,28.328964111571498,27658,28.328964111571498
Switzerland,2020,18372,16,2020-04-20,8606033,1320,15.33807736967776,28978,15.33807736967776
Switzerland,2020,18379,17,2020-04-27,8606033,844,9.807073712127295,29822,9.807073712127295
Switzerland,2020,18386,18,2020-05-04,8606033,400,4.647902233235685,30222,4.647902233235685
Switzerland,2020,18393,19,2020-05-11,8606033,282,3.276771074431158,30504,3.276771074431158
Switzerland,2020,18400,20,2020-05-18,8606033,149,1.7313435818802925,30653,1.7313435818802925
Switzerland,2020,18407,21,2020-05-25,8606033,126,1.4640892034692408,30779,1.4640892034692408
Switzerland,2020,18414,22,2020-06-01,8606033,103,1.1968348250581888,30882,1.1968348250581888
Switzerland,2020,18421,23,2020-06-08,8606033,152,1.7662028486295602,31034,1.7662028486295602
Switzerland,2020,18428,24,2020-06-15,8606033,175,2.033457227040612,31209,2.033457227040612
Switzerland,2020,18435,25,2020-06-22,8606033,325,3.776420564503994,31534,3.776420564503994
Switzerland,2020,18442,26,2020-06-29,8606033,650,7.552841129007988,32184,7.552841129007988
Switzerland,2020,18449,27,2020-07-06,8606033,614,7.134529928016776,32798,7.134529928016776
Switzerland,2020,18456,28,2020-07-13,8606033,706,8.203547441660984,33504,8.203547441660984
Switzerland,2020,18463,29,2020-07-20,8606033,821,9.539819333716244,34325,9.539819333716244
Switzerland,2020,18470,30,2020-07-27,8606033,1136,13.200042342389345,35461,13.200042342389345
Switzerland,2020,18477,31,2020-08-03,8606033,1053,12.23560262899294,36514,12.23560262899294
Switzerland,2020,18484,32,2020-08-10,8606033,1517,17.627169219546335,38031,17.627169219546335
Switzerland,2020,18491,33,2020-08-17,8606033,1771,20.578587137650995,39802,20.578587137650995
Switzerland,2020,18498,34,2020-08-24,8606033,2104,24.4479657468197,41906,24.4479657468197
Switzerland,2020,18505,35,2020-08-31,8606033,2387,27.73635657683395,44293,27.73635657683395
Switzerland,2020,18512,36,2020-09-07,8606033,2775,32.24482174307256,47068,32.24482174307256
Switzerland,2020,18519,37,2020-09-14,8606033,2103,24.436345991236614,49171,24.436345991236614
Switzerland,2020,18526,38,2020-09-21,8606033,2693,31.29200178525925,51864,31.29200178525925
Switzerland,2020,18533,39,2020-09-28,8606033,2399,27.87579364383102,54263,27.87579364383102
Switzerland,2020,18540,40,2020-10-05,8606033,5967,69.33508156429333,60230,69.33508156429333
Switzerland,2020,18547,41,2020-10-12,8606033,14192,164.90757123520208,74422,164.90757123520208
Switzerland,2020,18554,42,2020-10-19,8606033,28901,335.8225561068613,103323,335.8225561068613
Switzerland,2020,18561,43,2020-10-26,8606033,50405,585.6937801656118,153728,585.6937801656118
Switzerland,2020,18568,44,2020-11-02,8606033,57432,667.3458026479797,211160,667.3458026479797
Switzerland,2020,18575,45,2020-11-09,8606033,45026,523.1911148841749,256186,523.1911148841749
Switzerland,2020,18582,46,2020-11-16,8606033,33297,386.9030016501215,289483,386.9030016501215
Switzerland,2020,18589,47,2020-11-23,8606033,27534,319.9383502247784,317017,319.9383502247784
Switzerland,2020,18596,48,2020-11-30,8606033,26084,303.089704629299,343101,303.089704629299
Switzerland,2020,18603,49,2020-12-07,8606033,29228,339.6222161825315,372329,339.6222161825315
Switzerland,2020,18610,50,2020-12-14,8606033,39833,462.84972414119255,412162,462.84972414119255
Switzerland,2020,18617,51,2020-12-21,8606033,24084,279.8501934631206,436246,279.8501934631206
Switzerland,2020,18624,52,2020-12-28,8606033,23414,272.0649572224508,459660,272.0649572224508
Switzerland,2021,18631,0,2021-01-04,8606033,22434,260.6775967510234,482094,260.6775967510234
Switzerland,2021,18631,1,2021-01-04,8606033,15378,178.6886013567459,497472,178.6886013567459
Switzerland,2021,18638,2,2021-01-11,8606033,13605,158.08677470792873,511077,158.08677470792873
Switzerland,2021,18645,3,2021-01-18,8606033,11451,133.05782118195458,522528,133.05782118195458
Switzerland,2021,18652,4,2021-01-25,8606033,10027,116.51128923163553,532555,116.51128923163553
Switzerland,2021,18659,5,2021-02-01,8606033,8038,93.39959537687109,540593,93.39959537687109
Switzerland,2021,18666,6,2021-02-08,8606033,7007,81.41962737070611,547600,81.41962737070611
Switzerland,2021,18673,7,2021-02-15,8606033,7240,84.12703042156589,554840,84.12703042156589
Switzerland,2021,18680,8,2021-02-22,8606033,7524,87.42704100716323,562364,87.42704100716323
Switzerland,2021,18687,9,2021-03-01,8606033,8759,101.7774391522784,571123,101.7774391522784
Switzerland,2021,18694,10,2021-03-08,8606033,10416,121.03137415345724,581539,121.03137415345724
Switzerland,2021,18701,11,2021-03-15,8606033,12504,145.2934238109475,594043,145.2934238109475
Switzerland,2021,18708,12,2021-03-22,8606033,14020,162.90897327491075,608063,162.90897327491075
Switzerland,2021,18715,13,2021-03-29,8606033,15063,175.0283783480728,623126,175.0283783480728
Switzerland,2021,18722,14,2021-04-05,8606033,11268,130.93140591024925,634394,130.93140591024925
Switzerland,2021,18729,15,2021-04-12,8606033,14453,167.9403274423884,648847,167.9403274423884
Switzerland,2021,18736,16,2021-04-19,8606033,12069,140.2388301323037,660916,140.2388301323037
Switzerland,2021,18743,17,2021-04-26,8606033,10314,119.84615908398213,671230,119.84615908398213
Switzerland,2021,18750,18,2021-05-03,8606033,7848,91.19184181608414,679078,91.19184181608414
Switzerland,2021,18757,19,2021-05-10,8606033,7951,92.38867664114233,687029,92.38867664114233
Switzerland,2021,18764,20,2021-05-17,8606033,4607,53.532213971292,691636,53.532213971292
Switzerland,2021,18771,21,2021-05-24,8606033,3620,42.063515210782946,695256,42.063515210782946
Switzerland,2021,18778,22,2021-05-31,8606033,2361,27.43424293167363,697617,27.43424293167363
Switzerland,2021,18785,23,2021-06-07,8606033,1255,14.582793256776961,698872,14.582793256776961
Switzerland,2021,18792,24,2021-06-14,8606033,747,8.679957420567641,699619,8.679957420567641
Switzerland,2021,18799,25,2021-06-21,8606033,1026,11.921869228249532,700645,11.921869228249532
Switzerland,2021,18806,26,2021-06-28,8606033,1969,22.87929874310266,702614,22.87929874310266
Switzerland,2021,18813,27,2021-07-05,8606033,4116,47.8269139799952,706730,47.8269139799952
Switzerland,2021,18820,28,2021-07-12,8606033,4507,52.37023841298308,711237,52.37023841298308
Switzerland,2021,18827,29,2021-07-19,8606033,5257,61.08505510029999,716494,61.08505510029999
Switzerland,2021,18834,30,2021-07-26,8606033,7413,86.13724813744032,723907,86.13724813744032
Switzerland,2021,18841,31,2021-08-02,8606033,13779,160.10861217938626,737686,160.10861217938626
Switzerland,2021,18848,32,2021-08-09,8606033,17958,208.66757076111608,755644,208.66757076111608
Switzerland,2021,18855,33,2021-08-16,8606033,17939,208.44679540503736,773583,208.44679540503736
Switzerland,2021,18862,34,2021-08-23,8606033,18627,216.44118724620276,792210,216.44118724620276
Switzerland,2021,18869,35,2021-08-30,8606033,18412,213.94293979583858,810622,213.94293979583858
Switzerland,2021,18876,36,2021-09-06,8606033,12960,150.5920323568362,823582,150.5920323568362
Switzerland,2021,18883,37,2021-09-13,8606033,9342,108.55175665721941,832924,108.55175665721941
Switzerland,2021,18890,38,2021-09-20,8606033,11285,131.12894175516175,844209,131.12894175516175
Switzerland,2021,18897,39,2021-09-27,8606033,640,7.436643573177095,844849,7.436643573177095
Switzerland,2021,18904,40,2021-10-04,8606033,8500,98.7679224562583,853349,98.7679224562583
Switzerland,2021,18911,41,2021-10-11,8606033,5430,63.09527281617442,858779,63.09527281617442
Switzerland,2021,18918,42,2021-10-18,8606033,14631,170.00864393617826,873410,170.00864393617826
Switzerland,2021,18925,43,2021-10-25,8606033,16898,196.3506298430415,890308,196.3506298430415
Turkey,2020,18330,10,2020-03-09,83154997,18,0.02164632391244028,18,0.02164632391244028
Turkey,2020,18337,11,2020-03-16,83154997,1218,1.4647345847417925,1236,1.4647345847417925
Turkey,2020,18344,12,2020-03-23,83154997,8035,9.662678479803205,9271,9.662678479803205
Turkey,2020,18351,13,2020-03-30,83154997,17798,21.403404055200674,27069,21.403404055200674
Turkey,2020,18358,14,2020-04-06,83154997,29887,35.94131570950571,56956,35.94131570950571
Turkey,2020,18365,15,2020-04-13,83154997,29350,35.295533712784575,86306,35.295533712784575
Turkey,2020,18372,16,2020-04-20,83154997,23824,28.650112271665407,110130,28.650112271665407
Turkey,2020,18379,17,2020-04-27,83154997,15915,19.138958059249283,126045,19.138958059249283
Turkey,2020,18386,18,2020-05-04,83154997,12612,15.166857621316492,138657,15.166857621316492
Turkey,2020,18393,19,2020-05-11,83154997,10778,12.961337729348966,149435,12.961337729348966
Turkey,2020,18400,20,2020-05-18,83154997,7392,8.88942368670881,156827,8.88942368670881
Turkey,2020,18407,21,2020-05-25,83154997,7115,8.556310813167368,163942,8.556310813167368
Turkey,2020,18414,22,2020-06-01,83154997,6190,7.443930278778075,170132,7.443930278778075
Turkey,2020,18421,23,2020-06-08,83154997,8107,9.749263775452965,178239,9.749263775452965
Turkey,2020,18428,24,2020-06-15,83154997,9446,11.359509759828384,187685,11.359509759828384
Turkey,2020,18435,25,2020-06-22,83154997,9554,11.489387703303025,197239,11.489387703303025
Turkey,2020,18442,26,2020-06-29,83154997,8519,10.24472407833771,205758,10.24472407833771
Turkey,2020,18449,27,2020-07-06,83154997,7235,8.700619639250302,212993,8.700619639250302
Turkey,2020,18456,28,2020-07-13,83154997,6648,7.9947089649946115,219641,7.9947089649946115
Turkey,2020,18463,29,2020-07-20,83154997,6459,7.767422563913988,226100,7.767422563913988
Turkey,2020,18470,30,2020-07-27,83154997,47136,56.684506885376955,273236,56.684506885376955
Turkey,2020,18477,31,2020-08-03,83154997,55058,66.21129455395206,328294,66.21129455395206
Turkey,2020,18484,32,2020-08-10,83154997,55615,66.88112802168702,383909,66.88112802168702
Turkey,2020,18491,33,2020-08-17,83154997,56050,67.40424751623766,439959,67.40424751623766
Turkey,2020,18498,34,2020-08-24,83154997,57407,69.03613982452552,497366,69.03613982452552
Turkey,2020,18505,35,2020-08-31,83154997,58370,70.19421815384108,555736,70.19421815384108
Turkey,2020,18512,36,2020-09-07,83154997,58466,70.30966521470742,614202,70.30966521470742
Turkey,2020,18519,37,2020-09-14,83154997,58815,70.72936338389863,673017,70.72936338389863
Turkey,2020,18526,38,2020-09-21,83154997,58676,70.56220566035256,731693,70.56220566035256
Turkey,2020,18533,39,2020-09-28,83154997,57120,68.69100121547716,788813,68.69100121547716
Turkey,2020,18540,40,2020-10-05,83154997,58200,69.98978065022358,847013,69.98978065022358
Turkey,2020,18547,41,2020-10-12,83154997,59070,71.03601963932486,906083,71.03601963932486
Turkey,2020,18554,42,2020-10-19,83154997,61418,73.85966233634763,967501,73.85966233634763
Turkey,2020,18561,43,2020-10-26,83154997,62782,75.49997265949033,1030283,75.49997265949033
Turkey,2020,18568,44,2020-11-02,83154997,63892,76.83482930075748,1094175,76.83482930075748
Turkey,2020,18575,45,2020-11-09,83154997,67133,80.73237017854741,1161308,80.73237017854741
Turkey,2020,18582,46,2020-11-16,83154997,79659,95.79580647450447,1240967,95.79580647450447
Turkey,2020,18589,47,2020-11-23,83154997,159462,191.76478354030846,1400429,191.76478354030846
Turkey,2020,18596,48,2020-11-30,83154997,220667,265.3682977103589,1621096,265.3682977103589
Turkey,2020,18603,49,2020-12-07,83154997,215632,259.31333988262907,1836728,259.31333988262907
Turkey,2020,18610,50,2020-12-14,83154997,187873,225.93110068899406,2024601,225.93110068899406
Turkey,2020,18617,51,2020-12-21,83154997,122977,147.88888754334272,2147578,147.88888754334272
Turkey,2020,18624,52,2020-12-28,83154997,94334,113.44357333089675,2241912,113.44357333089675
Turkey,2021,18631,0,2021-01-04,83154997,84344,101.4298635594924,2326256,101.4298635594924
Turkey,2021,18631,1,2021-01-04,83154997,60845,73.17058769180161,2387101,73.17058769180161
Turkey,2021,18638,2,2021-01-11,83154997,42504,51.11418619857565,2429605,51.11418619857565
Turkey,2021,18645,3,2021-01-18,83154997,47858,57.55276498897595,2477463,57.55276498897595
Turkey,2021,18652,4,2021-01-25,83154997,53993,64.93055372246602,2531456,64.93055372246602
Turkey,2021,18659,5,2021-02-01,83154997,54727,65.8132427086733,2586183,65.8132427086733
Turkey,2021,18666,6,2021-02-08,83154997,52239,62.821239714553776,2638422,62.821239714553776
Turkey,2021,18673,7,2021-02-15,83154997,63166,75.96176090295572,2701588,75.96176090295572
Turkey,2021,18680,8,2021-02-22,83154997,78829,94.79767042743083,2780417,94.79767042743083
Turkey,2021,18687,9,2021-03-01,83154997,98973,119.02231203255289,2879390,119.02231203255289
Turkey,2021,18694,10,2021-03-08,83154997,133732,160.82256608102577,3013122,160.82256608102577
Turkey,2021,18701,11,2021-03-15,83154997,195051,234.56317363585498,3208173,234.56317363585498
Turkey,2021,18708,12,2021-03-22,83154997,278877,335.3701040960894,3487050,335.3701040960894
Turkey,2021,18715,13,2021-03-29,83154997,361961,435.28472498171095,3849011,435.28472498171095
Turkey,2021,18722,14,2021-04-05,83154997,419436,504.4026398076835,4268447,504.4026398076835
Turkey,2021,18729,15,2021-04-12,83154997,361522,434.75679519295755,4629969,434.75679519295755
Turkey,2021,18736,16,2021-04-19,83154997,245419,295.1343982370657,4875388,295.1343982370657
Turkey,2021,18743,17,2021-04-26,83154997,155944,187.53412978897708,5031332,187.53412978897708
Turkey,2021,18750,18,2021-05-03,83154997,86042,103.47183344856593,5117374,103.47183344856593
Turkey,2021,18757,19,2021-05-10,83154997,69113,83.11346580891585,5186487,83.11346580891585
Turkey,2021,18764,20,2021-05-17,83154997,56424,67.85401002419614,5242911,67.85401002419614
Turkey,2021,18771,21,2021-05-24,83154997,45069,54.19878735609839,5287980,54.19878735609839
Turkey,2021,18778,22,2021-05-31,83154997,42467,51.06969097720008,5330447,51.06969097720008
Turkey,2021,18785,23,2021-06-07,83154997,39852,47.924961142142784,5370299,47.924961142142784
Turkey,2021,18792,24,2021-06-14,83154997,38728,46.57326847116596,5409027,46.57326847116596
Turkey,2021,18799,25,2021-06-21,83154997,35759,43.00282759916401,5444786,43.00282759916401
Turkey,2021,18806,26,2021-06-28,83154997,31508,37.89068743517603,5476294,37.89068743517603
Turkey,2021,18813,27,2021-07-05,83154997,53425,64.24749194567345,5529719,64.24749194567345
Turkey,2021,18820,28,2021-07-12,83154997,57659,69.33918835929968,5587378,69.33918835929968
Turkey,2021,18827,29,2021-07-19,83154997,139667,167.9598401043776,5727045,167.9598401043776
Turkey,2021,18834,30,2021-07-26,83154997,144839,174.17955050855213,5871884,174.17955050855213
Turkey,2021,18841,31,2021-08-02,83154997,187922,225.99002679297794,6059806,225.99002679297794
Turkey,2021,18848,32,2021-08-09,83154997,137235,165.0351812290968,6197041,165.0351812290968
Turkey,2021,18855,33,2021-08-16,83154997,149840,180.19362083555845,6346881,180.19362083555845
Turkey,2021,18862,34,2021-08-23,83154997,151173,181.79665137862972,6498054,181.79665137862972
Turkey,2021,18869,35,2021-08-30,83154997,160197,192.64867510006644,6658251,192.64867510006644
Turkey,2021,18876,36,2021-09-06,83154997,189008,227.2960216690285,6847259,227.2960216690285
Turkey,2021,18883,37,2021-09-13,83154997,166380,200.08418736398968,7013639,200.08418736398968
Turkey,2021,18890,38,2021-09-20,83154997,197277,237.24010235969342,7210916,237.24010235969342
Turkey,2021,18897,39,2021-09-27,83154997,205266,246.84746245616483,7416182,246.84746245616483
Turkey,2021,18904,40,2021-10-04,83154997,213981,257.327890950438,7630163,257.327890950438
Turkey,2021,18911,41,2021-10-11,83154997,196850,236.7266034535483,7827013,236.7266034535483
Turkey,2021,18918,42,2021-10-18,83154997,182027,218.90085571165375,8009040,218.90085571165375
Turkey,2021,18925,43,2021-10-25,83154997,197335,237.3098516256335,8206375,237.3098516256335
Ukraine,2020,18330,10,2020-03-09,43733759,3,0.00685968933061528,3,0.00685968933061528
Ukraine,2020,18337,11,2020-03-16,43733759,44,0.10060877684902411,47,0.10060877684902411
Ukraine,2020,18344,12,2020-03-23,43733759,371,0.8483149138860897,418,0.8483149138860897
Ukraine,2020,18351,13,2020-03-30,43733759,890,2.0350411680825333,1308,2.0350411680825333
Ukraine,2020,18358,14,2020-04-06,43733759,1469,3.3589612088912824,2777,3.3589612088912824
Ukraine,2020,18365,15,2020-04-13,43733759,2672,6.10969663046801,5449,6.10969663046801
Ukraine,2020,18372,16,2020-04-20,43733759,3168,7.243831933129736,8617,7.243831933129736
Ukraine,2020,18379,17,2020-04-27,43733759,3296,7.536512011235988,11913,7.536512011235988
Ukraine,2020,18386,18,2020-05-04,43733759,3319,7.589102962770705,15232,7.589102962770705
Ukraine,2020,18393,19,2020-05-11,43733759,3059,6.994596554117381,18291,6.994596554117381
Ukraine,2020,18400,20,2020-05-18,43733759,2695,6.162287582002727,20986,6.162287582002727
Ukraine,2020,18407,21,2020-05-25,43733759,2686,6.141708514010881,23672,6.141708514010881
Ukraine,2020,18414,22,2020-06-01,43733759,3327,7.6073954676523465,26999,7.6073954676523465
Ukraine,2020,18421,23,2020-06-08,43733759,4155,9.500669722902163,31154,9.500669722902163
Ukraine,2020,18428,24,2020-06-15,43733759,5406,12.361160173768736,36560,12.361160173768736
Ukraine,2020,18435,25,2020-06-22,43733759,6422,14.68430829373711,42982,14.68430829373711
Ukraine,2020,18442,26,2020-06-29,43733759,5518,12.617255242111707,48500,12.617255242111707
Ukraine,2020,18449,27,2020-07-06,43733759,5021,11.480833376339774,53521,11.480833376339774
Ukraine,2020,18456,28,2020-07-13,43733759,5321,12.166802309401303,58842,12.166802309401303
Ukraine,2020,18463,29,2020-07-20,43733759,6007,13.735384603001997,64849,13.735384603001997
Ukraine,2020,18470,30,2020-07-27,43733759,7319,16.73535540359108,72168,16.73535540359108
Ukraine,2020,18477,31,2020-08-03,43733759,9789,22.38316628579766,81957,22.38316628579766
Ukraine,2020,18484,32,2020-08-10,43733759,10863,24.83893506615793,92820,24.83893506615793
Ukraine,2020,18491,33,2020-08-17,43733759,12138,27.754303031669426,104958,27.754303031669426
Ukraine,2020,18498,34,2020-08-24,43733759,14116,32.2771248636551,119074,32.2771248636551
Ukraine,2020,18505,35,2020-08-31,43733759,16820,38.459991513649676,135894,38.459991513649676
Ukraine,2020,18512,36,2020-09-07,43733759,18441,42.16651031529213,154335,42.16651031529213
Ukraine,2020,18519,37,2020-09-14,43733759,21343,48.80211646110731,175678,48.80211646110731
Ukraine,2020,18526,38,2020-09-21,43733759,22956,52.49034275786813,198634,52.49034275786813
Ukraine,2020,18533,39,2020-09-28,43733759,27828,63.63047823078734,226462,63.63047823078734
Ukraine,2020,18540,40,2020-10-05,43733759,34572,79.05105984601049,261034,79.05105984601049
Ukraine,2020,18547,41,2020-10-12,43733759,42604,97.4167347471778,303638,97.4167347471778
Ukraine,2020,18554,42,2020-10-19,43733759,39851,91.12182650478319,343489,91.12182650478319
Ukraine,2020,18561,43,2020-10-26,43733759,51951,118.78924013826482,395440,118.78924013826482
Ukraine,2020,18568,44,2020-11-02,43733759,64891,148.37736678431872,460331,148.37736678431872
Ukraine,2020,18575,45,2020-11-09,43733759,75526,172.69496546134988,535857,172.69496546134988
Ukraine,2020,18582,46,2020-11-16,43733759,76808,175.6263393686328,612665,175.6263393686328
Ukraine,2020,18589,47,2020-11-23,43733759,110014,251.55395400610317,722679,251.55395400610317
Ukraine,2020,18596,48,2020-11-30,43733759,90627,207.224354988557,813306,207.224354988557
Ukraine,2020,18603,49,2020-12-07,43733759,87360,199.75415330751696,900666,199.75415330751696
Ukraine,2020,18610,50,2020-12-14,43733759,70327,160.8071238513936,970993,160.8071238513936
Ukraine,2020,18617,51,2020-12-21,43733759,59381,135.77840404708866,1030374,135.77840404708866
Ukraine,2020,18624,52,2020-12-28,43733759,43719,99.96625261505649,1074093,99.96625261505649
Ukraine,2021,18631,0,2021-01-04,43733759,45221,103.40067040658454,1119314,103.40067040658454
Ukraine,2021,18631,1,2021-01-04,43733759,44402,101.52797521932656,1163716,101.52797521932656
Ukraine,2021,18638,2,2021-01-11,43733759,30612,69.99626992959833,1194328,69.99626992959833
Ukraine,2021,18645,3,2021-01-18,43733759,29551,67.57022646967071,1223879,67.57022646967071
Ukraine,2021,18652,4,2021-01-25,43733759,23111,52.84476003994992,1246990,52.84476003994992
Ukraine,2021,18659,5,2021-02-01,43733759,21059,48.152732537809065,1268049,48.152732537809065
Ukraine,2021,18666,6,2021-02-08,43733759,39613,90.57762448455436,1307662,90.57762448455436
Ukraine,2021,18673,7,2021-02-15,43733759,44472,101.68803463704091,1352134,101.68803463704091
Ukraine,2021,18680,8,2021-02-22,43733759,54666,124.99725898247164,1406800,124.99725898247164
Ukraine,2021,18687,9,2021-03-01,43733759,60748,138.904135818739,1467548,138.904135818739
Ukraine,2021,18694,10,2021-03-08,43733759,86708,198.26331415966325,1554256,198.26331415966325
Ukraine,2021,18701,11,2021-03-15,43733759,98153,224.43302895596054,1652409,224.43302895596054
Ukraine,2021,18708,12,2021-03-22,43733759,103479,236.61126408091286,1755888,236.61126408091286
Ukraine,2021,18715,13,2021-03-29,43733759,105217,240.5853107664493,1861105,240.5853107664493
Ukraine,2021,18722,14,2021-04-05,43733759,91911,210.16030202206034,1953016,210.16030202206034
Ukraine,2021,18729,15,2021-04-12,43733759,77317,176.7901999917272,2030333,176.7901999917272
Ukraine,2021,18736,16,2021-04-19,43733759,55605,127.14434174295423,2085938,127.14434174295423
Ukraine,2021,18743,17,2021-04-26,43733759,36389,83.20574501725315,2122327,83.20574501725315
Ukraine,2021,18750,18,2021-05-03,43733759,33673,76.99543960993611,2156000,76.99543960993611
Ukraine,2021,18757,19,2021-05-10,43733759,27855,63.69221543476288,2183855,63.69221543476288
Ukraine,2021,18764,20,2021-05-17,43733759,18639,42.61924981111274,2202494,42.61924981111274
Ukraine,2021,18771,21,2021-05-24,43733759,12558,28.714659537955566,2215052,28.714659537955566
Ukraine,2021,18778,22,2021-05-31,43733759,8926,20.409862321690664,2223978,20.409862321690664
Ukraine,2021,18785,23,2021-06-07,43733759,5868,13.417552330683488,2229846,13.417552330683488
Ukraine,2021,18792,24,2021-06-14,43733759,4435,10.140907393759589,2234281,10.140907393759589
Ukraine,2021,18799,25,2021-06-21,43733759,3542,8.099006536346442,2237823,8.099006536346442
Ukraine,2021,18806,26,2021-06-28,43733759,3394,7.760595196036087,2241217,7.760595196036087
Ukraine,2021,18813,27,2021-07-05,43733759,3460,7.9115083613096235,2244677,7.9115083613096235
Ukraine,2021,18820,28,2021-07-12,43733759,3986,9.114240557277503,2248663,9.114240557277503
Ukraine,2021,18827,29,2021-07-19,43733759,4606,10.53190968560466,2253269,10.53190968560466
Ukraine,2021,18834,30,2021-07-26,43733759,6182,14.135533147287887,2259451,14.135533147287887
Ukraine,2021,18841,31,2021-08-02,43733759,6878,15.726981071990632,2266329,15.726981071990632
Ukraine,2021,18848,32,2021-08-09,43733759,8842,20.217791020433438,2275171,20.217791020433438
Ukraine,2021,18855,33,2021-08-16,43733759,9769,22.33743502359356,2284940,22.33743502359356
Ukraine,2021,18862,34,2021-08-23,43733759,13367,30.564489094111487,2298307,30.564489094111487
Ukraine,2021,18869,35,2021-08-30,43733759,19517,44.62685222187281,2317824,44.62685222187281
Ukraine,2021,18876,36,2021-09-06,43733759,32822,75.04957440315158,2350646,75.04957440315158
Ukraine,2021,18883,37,2021-09-13,43733759,44758,102.34199168655958,2395404,102.34199168655958
Ukraine,2021,18890,38,2021-09-20,43733759,64606,147.72569629791028,2460010,147.72569629791028
Ukraine,2021,18897,39,2021-09-27,43733759,90079,205.9713184041646,2550089,205.9713184041646
Ukraine,2021,18904,40,2021-10-04,43733759,94605,216.32030304095287,2644694,216.32030304095287
Ukraine,2021,18911,41,2021-10-11,43733759,139345,318.62113659152874,2784039,318.62113659152874
Ukraine,2021,18918,42,2021-10-18,43733759,152199,348.01261881010504,2936238,348.01261881010504
Ukraine,2021,18925,43,2021-10-25,43733759,152263,348.1589588491581,3088501,348.1589588491581
United Kingdom,2020,18267,0,2020-01-06,68059863,0,0,0,0
United Kingdom,2020,18267,1,2020-01-06,68059863,0,0,0,0
United Kingdom,2020,18274,2,2020-01-13,68059863,0,0,0,0
United Kingdom,2020,18281,3,2020-01-20,68059863,0,0,0,0
United Kingdom,2020,18288,4,2020-01-27,68059863,2,0.002938589517877813,2,0.002938589517877813
United Kingdom,2020,18295,5,2020-02-03,68059863,6,0.00881576855363344,8,0.00881576855363344
United Kingdom,2020,18302,6,2020-02-10,68059863,2,0.002938589517877813,10,0.002938589517877813
United Kingdom,2020,18309,7,2020-02-17,68059863,1,0.0014692947589389064,11,0.0014692947589389064
United Kingdom,2020,18316,8,2020-02-24,68059863,36,0.052894611321800636,47,0.052894611321800636
United Kingdom,2020,18323,9,2020-03-02,68059863,365,0.5362925870127009,412,0.5362925870127009
United Kingdom,2020,18330,10,2020-03-09,68059863,2193,3.222163406353022,2605,3.222163406353022
United Kingdom,2020,18337,11,2020-03-16,68059863,6329,9.299166529324339,8934,9.299166529324339
United Kingdom,2020,18344,12,2020-03-23,68059863,17889,26.2842139426581,26823,26.2842139426581
United Kingdom,2020,18351,13,2020-03-30,68059863,30357,44.60338099710838,57180,44.60338099710838
United Kingdom,2020,18358,14,2020-04-06,68059863,32205,47.31863771162748,89385,47.31863771162748
United Kingdom,2020,18365,15,2020-04-13,68059863,32027,47.05710324453636,121412,47.05710324453636
United Kingdom,2020,18372,16,2020-04-20,68059863,32830,48.2369469359643,154242,48.2369469359643
United Kingdom,2020,18379,17,2020-04-27,68059863,31282,45.96247864912687,185524,45.96247864912687
United Kingdom,2020,18386,18,2020-05-04,68059863,22867,33.59836325265597,208391,33.59836325265597
United Kingdom,2020,18393,19,2020-05-11,68059863,19857,29.175786028249867,228248,29.175786028249867
United Kingdom,2020,18400,20,2020-05-18,68059863,16360,24.03766225624051,244608,24.03766225624051
United Kingdom,2020,18407,21,2020-05-25,68059863,10907,16.025597935746653,255515,16.025597935746653
United Kingdom,2020,18414,22,2020-06-01,68059863,8524,12.52426852519524,264039,12.52426852519524
United Kingdom,2020,18421,23,2020-06-08,68059863,7136,10.484887399788036,271175,10.484887399788036
United Kingdom,2020,18428,24,2020-06-15,68059863,6680,9.814888989711894,277855,9.814888989711894
United Kingdom,2020,18435,25,2020-06-22,68059863,5240,7.69910453683987,283095,7.69910453683987
United Kingdom,2020,18442,26,2020-06-29,68059863,4026,5.915380699488037,287121,5.915380699488037
United Kingdom,2020,18449,27,2020-07-06,68059863,4271,6.27535791542807,291392,6.27535791542807
United Kingdom,2020,18456,28,2020-07-13,68059863,4310,6.332660411026687,295702,6.332660411026687
United Kingdom,2020,18463,29,2020-07-20,68059863,4549,6.6838218584130855,300251,6.6838218584130855
United Kingdom,2020,18470,30,2020-07-27,68059863,4444,6.529545908724501,304695,6.529545908724501
United Kingdom,2020,18477,31,2020-08-03,68059863,6130,9.006776872295497,310825,9.006776872295497
United Kingdom,2020,18484,32,2020-08-10,68059863,7659,11.253328558713084,318484,11.253328558713084
United Kingdom,2020,18491,33,2020-08-17,68059863,7158,10.517211884484693,325642,10.517211884484693
United Kingdom,2020,18498,34,2020-08-24,68059863,8825,12.96652624763585,334467,12.96652624763585
United Kingdom,2020,18505,35,2020-08-31,68059863,12685,18.63800401714003,347152,18.63800401714003
United Kingdom,2020,18512,36,2020-09-07,68059863,21352,31.37238169286353,368504,31.37238169286353
United Kingdom,2020,18519,37,2020-09-14,68059863,25753,37.83874792695366,394257,37.83874792695366
United Kingdom,2020,18526,38,2020-09-21,68059863,40712,59.81792822592076,434969,59.81792822592076
United Kingdom,2020,18533,39,2020-09-28,68059863,68009,99.9252672606761,502978,99.9252672606761
United Kingdom,2020,18540,40,2020-10-05,68059863,100738,148.01381542598756,603716,148.01381542598756
United Kingdom,2020,18547,41,2020-10-12,68059863,118693,174.39500282273562,722409,174.39500282273562
United Kingdom,2020,18554,42,2020-10-19,68059863,151391,222.43800285051998,873800,222.43800285051998
United Kingdom,2020,18561,43,2020-10-26,68059863,161114,236.72395579168298,1034914,236.72395579168298
United Kingdom,2020,18568,44,2020-11-02,68059863,157099,230.82473733454327,1192013,230.82473733454327
United Kingdom,2020,18575,45,2020-11-09,68059863,177305,260.51330723366283,1369318,260.51330723366283
United Kingdom,2020,18582,46,2020-11-16,68059863,142727,209.7080330590733,1512045,209.7080330590733
United Kingdom,2020,18589,47,2020-11-23,68059863,105282,154.69029081060594,1617327,154.69029081060594
United Kingdom,2020,18596,48,2020-11-30,68059863,105915,155.62035439301428,1723242,155.62035439301428
United Kingdom,2020,18603,49,2020-12-07,68059863,126161,185.3676960824914,1849403,185.3676960824914
United Kingdom,2020,18610,50,2020-12-14,68059863,190744,280.25915949904277,2040147,280.25915949904277
United Kingdom,2020,18617,51,2020-12-21,68059863,289583,425.48278417780534,2329730,425.48278417780534
United Kingdom,2020,18624,52,2020-12-28,68059863,325049,477.5927920983326,2654779,477.5927920983326
United Kingdom,2021,18631,0,2021-01-04,68059863,417570,613.5334124901192,3072349,613.5334124901192
United Kingdom,2021,18631,1,2021-01-04,68059863,323610,475.47847694021954,3395959,475.47847694021954
United Kingdom,2021,18638,2,2021-01-11,68059863,251504,369.53350905217076,3647463,369.53350905217076
United Kingdom,2021,18645,3,2021-01-18,68059863,169713,249.35842142379863,3817176,249.35842142379863
United Kingdom,2021,18652,4,2021-01-25,68059863,142608,209.5331869827596,3959784,209.5331869827596
United Kingdom,2021,18659,5,2021-02-01,68059863,78294,115.03696385636275,4038078,115.03696385636275
United Kingdom,2021,18666,6,2021-02-08,68059863,77431,113.76896247939847,4115509,113.76896247939847
United Kingdom,2021,18673,7,2021-02-15,68059863,61045,89.69309855942555,4176554,89.69309855942555
United Kingdom,2021,18680,8,2021-02-22,68059863,41966,61.66042385363015,4218520,61.66042385363015
United Kingdom,2021,18687,9,2021-03-01,68059863,39918,58.651308187323266,4258438,58.651308187323266
United Kingdom,2021,18694,10,2021-03-08,68059863,38145,56.04624857972459,4296583,56.04624857972459
United Kingdom,2021,18701,11,2021-03-15,68059863,36459,53.569017616153594,4333042,53.569017616153594
United Kingdom,2021,18708,12,2021-03-22,68059863,26346,38.71003971900443,4359388,38.71003971900443
United Kingdom,2021,18715,13,2021-03-29,68059863,13955,20.50400836099244,4373343,20.50400836099244
United Kingdom,2021,18722,14,2021-04-05,68059863,14477,21.27098022515855,4387820,21.27098022515855
United Kingdom,2021,18729,15,2021-04-12,68059863,17062,25.06910717701562,4404882,25.06910717701562
United Kingdom,2021,18736,16,2021-04-19,68059863,15319,22.50812641218511,4420201,22.50812641218511
United Kingdom,2021,18743,17,2021-04-26,68059863,14659,21.53839187128543,4434860,21.53839187128543
United Kingdom,2021,18750,18,2021-05-03,68059863,15917,23.386764678030573,4450777,23.386764678030573
United Kingdom,2021,18757,19,2021-05-10,68059863,11761,17.28037565988048,4462538,17.28037565988048
United Kingdom,2021,18764,20,2021-05-17,68059863,21518,31.616284622847388,4484056,31.616284622847388
United Kingdom,2021,18771,21,2021-05-24,68059863,32836,48.24576270451794,4516892,48.24576270451794
United Kingdom,2021,18778,22,2021-05-31,68059863,56527,83.05482483853956,4573419,83.05482483853956
United Kingdom,2021,18785,23,2021-06-07,68059863,56621,83.19293854587983,4630040,83.19293854587983
United Kingdom,2021,18792,24,2021-06-14,68059863,102394,150.44696754679038,4732434,150.44696754679038
United Kingdom,2021,18799,25,2021-06-21,68059863,198099,291.06582245103846,4930533,291.06582245103846
United Kingdom,2021,18806,26,2021-06-28,68059863,190712,280.2121420667567,5121245,280.2121420667567
United Kingdom,2021,18813,27,2021-07-05,68059863,312694,459.43965535164244,5433939,459.43965535164244
United Kingdom,2021,18820,28,2021-07-12,68059863,263973,387.85414540138,5697912,387.85414540138
United Kingdom,2021,18827,29,2021-07-19,68059863,182755,268.52096366987985,5880667,268.52096366987985
United Kingdom,2021,18834,30,2021-07-26,68059863,213576,313.8060974351359,6094243,313.8060974351359
United Kingdom,2021,18841,31,2021-08-02,68059863,173194,254.47303647966496,6267437,254.47303647966496
United Kingdom,2021,18848,32,2021-08-09,68059863,225469,331.2804200031963,6492906,331.2804200031963
United Kingdom,2021,18855,33,2021-08-16,68059863,238517,350.45177801783115,6731423,350.45177801783115
United Kingdom,2021,18862,34,2021-08-23,68059863,246703,362.47942491450505,6978126,362.47942491450505
United Kingdom,2021,18869,35,2021-08-30,68059863,248150,364.60549443068965,7226276,364.60549443068965
United Kingdom,2021,18876,36,2021-09-06,68059863,203470,298.9574046012993,7429746,298.9574046012993
United Kingdom,2021,18883,37,2021-09-13,68059863,234484,344.52611225503057,7664230,344.52611225503057
United Kingdom,2021,18890,38,2021-09-20,68059863,236450,347.4147457511044,7900680,347.4147457511044
United Kingdom,2021,18897,39,2021-09-27,68059863,293089,430.63413160264514,8193769,430.63413160264514
United Kingdom,2021,18904,40,2021-10-04,68059863,255396,375.25200425396093,8449165,375.25200425396093
United Kingdom,2021,18911,41,2021-10-11,68059863,324509,476.7993729285056,8773674,476.7993729285056
United Kingdom,2021,18918,42,2021-10-18,68059863,312625,459.3382740132756,9086299,459.3382740132756
United Kingdom,2021,18925,43,2021-10-25,68059863,215610,316.79464297481763,9301909,316.79464297481763
